####################################################
# Syntax Coloring Map For BMC Library
####################################################

####################################################
# Classes/Structs (KEYWORD1)
####################################################
BMC	KEYWORD1
BMCTimer	KEYWORD1
BMCFlags	KEYWORD1
BMCMidiDataChannel	KEYWORD1
BMCMidiData	KEYWORD1
BMCMidiEvent	KEYWORD1
BMCMidiPort	KEYWORD1
BMCEditorMidiFlags	KEYWORD1
BMCSketchByteData	KEYWORD1
BMCRelayMidiTrigger	KEYWORD1
BMCValueStream	KEYWORD1
BMCRoutingItem	KEYWORD1
BMCRoutingData	KEYWORD1
BMCMidiTimeSignature	KEYWORD1
bmcStoreButtonEvent	KEYWORD1
bmcStoreButton	KEYWORD1
bmcStorePot	KEYWORD1
bmcStoreEncoder	KEYWORD1
bmcStoreLed	KEYWORD1
bmcStoreGlobalRelay	KEYWORD1
bmcStorePage	KEYWORD1
bmcStoreGlobalLibrary	KEYWORD1
bmcStoreGlobalPresets	KEYWORD1
bmcStoreGlobalCustomSysEx	KEYWORD1
bmcStoreGlobalTriggers	KEYWORD1
bmcStoreGlobalPotCalibration	KEYWORD1
bmcStoreGlobalTempoToTap	KEYWORD1
bmcStorePortPresets	KEYWORD1
bmcStoreGlobalSettings	KEYWORD1
bmcStoreGlobal	KEYWORD1
bmcStore	KEYWORD1

####################################################
# Methods/Functions (KEYWORD2)
####################################################

setup	KEYWORD2
begin	KEYWORD2
update	KEYWORD2
setPage	KEYWORD2
pageChanged	KEYWORD2
pageChangedPeek	KEYWORD2
scrollPage	KEYWORD2
scrollPage	KEYWORD2
getPage	KEYWORD2
setPage	KEYWORD2
pageChanged	KEYWORD2
pageChangedPeek	KEYWORD2
scrollPage	KEYWORD2
scrollPage	KEYWORD2
getPage	KEYWORD2
getPageName	KEYWORD2
getPageName	KEYWORD2
getSketchByte	KEYWORD2
getSketchByteData	KEYWORD2
setSketchByte	KEYWORD2
saveSketchBytes	KEYWORD2
getButton	KEYWORD2
getButton	KEYWORD2
getButtonName	KEYWORD2
getButtonName	KEYWORD2
triggerButtonPress	KEYWORD2
triggerButtonRelease	KEYWORD2
getLed	KEYWORD2
getLed	KEYWORD2
getLedName	KEYWORD2
getLedName	KEYWORD2
getPwmLed	KEYWORD2
getPwmLed	KEYWORD2
getPwmLedName	KEYWORD2
getPwmLedName	KEYWORD2
getEncoder	KEYWORD2
getEncoder	KEYWORD2
getEncoderName	KEYWORD2
getEncoderName	KEYWORD2
getPot	KEYWORD2
getPot	KEYWORD2
getPotName	KEYWORD2
getPotName	KEYWORD2
getGlobalLed	KEYWORD2
getGlobalLedName	KEYWORD2
getRelayNL	KEYWORD2
getRelayNLName	KEYWORD2
getRelayL	KEYWORD2
getRelayLName	KEYWORD2
sendRealTime	KEYWORD2
sendSysEx	KEYWORD2
sendProgramChange	KEYWORD2
sendControlChange	KEYWORD2
sendNoteOn	KEYWORD2
sendNoteOff	KEYWORD2
sendPitchBend	KEYWORD2
sendAfterTouch	KEYWORD2
sendAfterTouchPoly	KEYWORD2
sendTimeCodeQuarterFrame	KEYWORD2
sendSongPosition	KEYWORD2
sendSongSelect	KEYWORD2
sendTuneRequest	KEYWORD2
beginRpn	KEYWORD2
sendRpnValue	KEYWORD2
sendRpnIncrement	KEYWORD2
sendRpnDecrement	KEYWORD2
endRpn	KEYWORD2
beginNrpn	KEYWORD2
sendNrpnValue	KEYWORD2
sendNrpnIncrement	KEYWORD2
sendNrpnDecrement	KEYWORD2
endNrpn	KEYWORD2
getHour	KEYWORD2
getMinute	KEYWORD2
getSecond	KEYWORD2
getDay	KEYWORD2
getMonth	KEYWORD2
getYear	KEYWORD2
onOneSecondPassed	KEYWORD2
onButtonActivity	KEYWORD2
onEncoderActivity	KEYWORD2
onPotActivity	KEYWORD2
onPageChange	KEYWORD2
onEditorUpdate	KEYWORD2
onEditorConnection	KEYWORD2
onValueStream	KEYWORD2
onTrigger	KEYWORD2
onMidiRx	KEYWORD2
onMidiClockTick	KEYWORD2
onMidiClockBeat	KEYWORD2
onMidiClockBpmChange	KEYWORD2
onMidiActivity	KEYWORD2
onHostConnectionChange	KEYWORD2
onBleConnectionChange	KEYWORD2
onMenu	KEYWORD2
onBeatBuddyBeatLocationChange	KEYWORD2


####################################################
# Preprocessors/Macros (KEYWORD2)
####################################################

BMC_WARN_HEAD	LITERAL1
BMC_WARN_FOOT	LITERAL1
BMC_INFO_HEAD	LITERAL1
BMC_INFO_FOOT	LITERAL1
BMC_ERROR_HEAD	LITERAL1
BMC_ERROR_FOOT	LITERAL1
BMC_DEBUG_PRINT	LITERAL1
BMC_DEBUG_PRINTNS	LITERAL1
BMC_DEBUG_PRINTLN	LITERAL1
BMC_DEBUG_PRINTLNNS	LITERAL1
BMC_DEBUG_WARN	LITERAL1
BMC_DEBUG_INFO	LITERAL1
BMC_DEBUG_ERROR	LITERAL1
BMC_PRINT	LITERAL1
BMC_PRINTNS	LITERAL1
BMC_PRINTLN	LITERAL1
BMC_PRINTLNNS	LITERAL1
BMC_PRINT_SYSEX	LITERAL1
BMC_PRINT_HEX	LITERAL1
BMC_PRINTLN_HEX	LITERAL1
BMC_PRINTSL	LITERAL1
BMC_WARN	LITERAL1
BMC_WARNING	LITERAL1
BMC_INFO	LITERAL1
BMC_NOTICE	LITERAL1
BMC_ERROR	LITERAL1
BMC_LIMIT_MIN_LIBRARY	LITERAL1
BMC_LIMIT_MAX_LIBRARY	LITERAL1
BMC_LIMIT_MIN_PRESETS	LITERAL1
BMC_LIMIT_MAX_PRESETS	LITERAL1
BMC_LIMIT_MIN_PRESET_ITEMS	LITERAL1
BMC_LIMIT_MAX_PRESET_ITEMS	LITERAL1
BMC_LIMIT_MIN_CUSTOM_SYSEX	LITERAL1
BMC_LIMIT_MAX_CUSTOM_SYSEX	LITERAL1
BMC_LIMIT_MIN_SKETCH_BYTES	LITERAL1
BMC_LIMIT_MAX_SKETCH_BYTES	LITERAL1
BMC_LIMIT_MIN_TRIGGERS	LITERAL1
BMC_LIMIT_MAX_TRIGGERS	LITERAL1
BMC_LIMIT_MIN_TEMPO_TO_TAP	LITERAL1
BMC_LIMIT_MAX_TEMPO_TO_TAP	LITERAL1
BMC_LIMIT_MIN_RELAYS	LITERAL1
BMC_LIMIT_MAX_RELAYS	LITERAL1
BMC_LIMIT_MIN_PAGES	LITERAL1
BMC_LIMIT_MAX_PAGES	LITERAL1
BMC_LIMIT_MIN_BUTTON_EVENTS	LITERAL1
BMC_LIMIT_MAX_BUTTON_EVENTS	LITERAL1
BMC_MIDI_SYSEX_SIZE	LITERAL1
BMC_DEVICE_NAME	LITERAL1
BMC_USB_HOST_ENABLED	LITERAL1
BMC_MIDI_SERIAL_ENABLED	LITERAL1
BMC_MIDI_SERIAL2_ENABLED	LITERAL1
BMC_MIDI_SERIAL3_ENABLED	LITERAL1
BMC_MIDI_SERIAL4_ENABLED	LITERAL1
BMC_MIDI_BLE_ENABLED	LITERAL1
BMC_MAX_SKETCH_BYTES	LITERAL1
BMC_SD_CARD_ENABLED	LITERAL1
BMC_MAX_PAGES	LITERAL1
BMC_MAX_CUSTOM_SYSEX	LITERAL1
BMC_MAX_TRIGGERS	LITERAL1
BMC_MAX_TEMPO_TO_TAP	LITERAL1
BMC_MAX_LIBRARY	LITERAL1
BMC_MAX_PRESETS	LITERAL1
BMC_MAX_PRESET_ITEMS	LITERAL1
BMC_MAX_BUTTON_EVENTS	LITERAL1
BMC_HAS_HARDWARE	LITERAL1
BMC_NAME_LEN_BUTTONS	LITERAL1
BMC_NAME_LEN_RELAYS	LITERAL1
BMC_NAME_LEN_LEDS	LITERAL1
BMC_NAME_LEN_POTS	LITERAL1
BMC_NAME_LEN_ENCODERS	LITERAL1
BMC_ENCODER_INPUT	LITERAL1
BMC_BUTTON_DELAY_ENABLED	LITERAL1
BMC_NAME_LEN_LIBRARY	LITERAL1
BMC_NAME_LEN_PRESETS	LITERAL1
BMC_NAME_LEN_PAGES	LITERAL1
BMC_CRC	LITERAL1
BMC_VERSION	LITERAL1
TEENSY_MODEL	LITERAL1
TEENSY_RAM_SIZE	LITERAL1
TEENSY_EEPROM_SIZE	LITERAL1
TEENSY_HAS_USB_HOST	LITERAL1
TEENSY_HAS_SD_CARD	LITERAL1
TEENSY_TOTAL_SERIAL_PORTS	LITERAL1


BMC_MIDI_NOTE_OFF	LITERAL1
BMC_MIDI_NOTE_ON	LITERAL1
BMC_MIDI_AFTER_TOUCH_POLY	LITERAL1
BMC_MIDI_CONTROL_CHANGE	LITERAL1
BMC_MIDI_PROGRAM_CHANGE	LITERAL1
BMC_MIDI_AFTER_TOUCH	LITERAL1
BMC_MIDI_PITCH_BEND	LITERAL1
BMC_MIDI_SYSTEM_EXCLUSIVE	LITERAL1
BMC_MIDI_TIME_CODE_QUARTER_FRAME	LITERAL1
BMC_MIDI_SONG_POSITION	LITERAL1
BMC_MIDI_SONG_SELECT	LITERAL1
BMC_MIDI_TUNE_REQUEST	LITERAL1
BMC_MIDI_RT_CLOCK	LITERAL1
BMC_MIDI_RT_START	LITERAL1
BMC_MIDI_RT_CONTINUE	LITERAL1
BMC_MIDI_RT_STOP	LITERAL1
BMC_MIDI_RT_ACTIVE_SENSE	LITERAL1
BMC_MIDI_RT_SYSTEM_RESET	LITERAL1

BMC_NONE	LITERAL1
BMC_NULL	LITERAL1
BMC_INVALID	LITERAL1
BMC_IGNORE	LITERAL1
BMC_SCROLL_DOWN	LITERAL1
BMC_SCROLL_UP	LITERAL1
BMC_SCROLL_LIMITED	LITERAL1
BMC_SCROLL_ENDLESS	LITERAL1
BMC_MENU_ENTER	LITERAL1
BMC_MENU_SELECT	LITERAL1
BMC_MENU_BACK	LITERAL1
BMC_MENU_EXIT	LITERAL1
BMC_MENU_UP	LITERAL1
BMC_MENU_DOWN	LITERAL1
BMC_MENU_RIGHT	LITERAL1
BMC_MENU_LEFT	LITERAL1
BMC_MENU_INC	LITERAL1
BMC_MENU_DEC	LITERAL1
BMC_MENU_SAVE	LITERAL1
BMC_ITEM_ID_PAGE	LITERAL1
BMC_ITEM_ID_BUTTON	LITERAL1
BMC_ITEM_ID_GLOBAL_BUTTON	LITERAL1
BMC_ITEM_ID_LED	LITERAL1
BMC_ITEM_ID_GLOBAL_LED	LITERAL1
BMC_ITEM_ID_ENCODER	LITERAL1
BMC_ITEM_ID_GLOBAL_ENCODER	LITERAL1
BMC_ITEM_ID_POT	LITERAL1
BMC_ITEM_ID_GLOBAL_POT	LITERAL1
BMC_ITEM_ID_PWM_LED	LITERAL1
BMC_ITEM_ID_RGB_PIXEL	LITERAL1
BMC_ITEM_ID_PIXEL	LITERAL1
BMC_ITEM_ID_NL_RELAY	LITERAL1
BMC_ITEM_ID_L_RELAY	LITERAL1
BMC_ITEM_ID_LIBRARY	LITERAL1
BMC_ITEM_ID_PRESET	LITERAL1
BMC_ITEM_ID_CUSTOM_SYSEX	LITERAL1
BMC_ITEM_ID_TRIGGER	LITERAL1
BMC_ITEM_ID_TEMPO_TO_TAP	LITERAL1
BMC_ITEM_ID_SKETCH_BYTES	LITERAL1
BMC_ITEM_ID_STRING_LIBRARY	LITERAL1
BMC_ITEM_ID_SETLIST	LITERAL1
BMC_ITEM_ID_SETLIST_SONG	LITERAL1
BMC_ITEM_ID_MIDI_PROGRAM	LITERAL1
BMC_ITEM_ID_MIDI_CONTROL	LITERAL1
BMC_ITEM_ID_MIDI_NOTE_ON	LITERAL1
BMC_ITEM_ID_MIDI_NOTE_OFF	LITERAL1
BMC_ITEM_ID_MIDI_PITCH_BEND	LITERAL1
BMC_ITEM_ID_MIDI_CLOCK	LITERAL1
BMC_ACTIVE_SENSE_STOP	LITERAL1
BMC_ACTIVE_SENSE_START	LITERAL1
BMC_ACTIVE_SENSE_TOGGLE	LITERAL1
BMC_RELAY_NO	LITERAL1
BMC_RELAY_NC	LITERAL1
BMC_RELAY_TOGGLE	LITERAL1
BMC_RELAY_OPEN	LITERAL1
BMC_RELAY_CLOSE	LITERAL1
BMC_RELAY_CLOSED	LITERAL1
BMC_RELAY_RESET	LITERAL1
BMC_RELAY_SET	LITERAL1
BMC_STOPWATCH_CMD_STOP	LITERAL1
BMC_STOPWATCH_CMD_START	LITERAL1
BMC_STOPWATCH_CMD_RESET	LITERAL1
BMC_STOPWATCH_CMD_TOGGLE	LITERAL1
BMC_STOPWATCH_CMD_TOGGLE_RESET	LITERAL1
BMC_CLICK_TRACK_MUTE	LITERAL1
BMC_CLICK_TRACK_UNMUTE	LITERAL1
BMC_CLICK_TRACK_MUTE_TOGGLE	LITERAL1
BMC_CLICK_TRACK_FREQ_INCREASE	LITERAL1
BMC_CLICK_TRACK_FREQ_DECREASE	LITERAL1
BMC_CLICK_TRACK_LEVEL_INCREASE	LITERAL1
BMC_CLICK_TRACK_LEVEL_DECREASE	LITERAL1
BMC_MIDI_PORT_USB_BIT	LITERAL1
BMC_MIDI_PORT_SERIAL_A_BIT	LITERAL1
BMC_MIDI_PORT_SERIAL_B_BIT	LITERAL1
BMC_MIDI_PORT_SERIAL_C_BIT	LITERAL1
BMC_MIDI_PORT_SERIAL_D_BIT	LITERAL1
BMC_MIDI_PORT_HOST_BIT	LITERAL1
BMC_MIDI_PORT_BLE_BIT	LITERAL1
BMC_USB	LITERAL1
BMC_SERIAL_A	LITERAL1
BMC_SERIAL_B	LITERAL1
BMC_SERIAL_C	LITERAL1
BMC_SERIAL_D	LITERAL1
BMC_HOST	LITERAL1
BMC_BLE	LITERAL1
BMC_ACTIVE	LITERAL1
BMC_COMPLETE	LITERAL1
BMC_NAME_LEN_SKETCH_BYTES	LITERAL1
BMC_EDITOR_SYSEX_MIN_LENGTH	LITERAL1
BMC_EDITOR_SYSEX_ID	LITERAL1
BMC_MIDI_SYSEX_SIZE	LITERAL1
BMC_DELAY_SYSEX_ON_SERIAL	LITERAL1
BMC_CUSTOM_SYSEX_SEND_A	LITERAL1
BMC_CUSTOM_SYSEX_SEND_B	LITERAL1
BMC_CUSTOM_SYSEX_SEND_MERGE	LITERAL1
BMC_L_RELAY_HOLD_TIME	LITERAL1
BMC_RELAYS_MOMENTARY_HOLD	LITERAL1
BMC_BUTTON_DEBOUNCE_TIME	LITERAL1
BMC_BUTTON_DOUBLE_PRESS_THRESHOLD	LITERAL1
BMC_LED_PULSE_TIMEOUT	LITERAL1
BMC_LED_PWM_DIM_VALUE	LITERAL1
BMC_LED_PWM_MAX_VALUE	LITERAL1
BMC_LED_PWM_MAX_VALUE	LITERAL1
BMC_LED_PWM_DIM_VALUE	LITERAL1
BMC_PAGE_LED_DIM	LITERAL1
BMC_GLOBAL_LED_DIM	LITERAL1
BMC_LED_BLINK_TIMEOUT	LITERAL1
BMC_LEDS_MAX_TEMP_BLINKER	LITERAL1
BMC_RESET_INCOMING_EDITOR_MESSAGES	LITERAL1
BMC_USE_USB_MIDI_BIG_BUFFER	LITERAL1
BMC_BLE_MIDI_DEVICE_NAME	LITERAL1
BMC_FS_MAX_STORES	LITERAL1
BMC_BUTTON_PRESS_TYPE_PRESS	LITERAL1
BMC_BUTTON_PRESS_TYPE_RELEASE	LITERAL1
BMC_BUTTON_PRESS_TYPE_HOLD	LITERAL1
BMC_BUTTON_PRESS_TYPE_DOUBLE_PRESS	LITERAL1
BMC_BUTTON_PRESS_TYPE_CONTINUOUS	LITERAL1
BMC_BUTTON_PRESS_TYPE_ALT_PRESS	LITERAL1
BMC_BUTTON_PRESS_TYPE_RELEASE_PRESS	LITERAL1
BMC_BUTTON_PRESS_TYPE_RELEASE_HOLD	LITERAL1
BMC_BUTTON_PRESS_TYPE_RELEASE_DOUBLE_PRESS	LITERAL1
BMC_BUTTON_PRESS_TYPE_RELEASE_CONTINUOUS	LITERAL1
BMC_BUTTON_PRESS_TYPE_RELEASE_ALT	LITERAL1
BMC_BEATBUDDY_CC_TEMPO_INC	LITERAL1
BMC_BEATBUDDY_CC_TEMPO_DEC	LITERAL1
BMC_BEATBUDDY_CC_HALF_TIME	LITERAL1
BMC_BEATBUDDY_CC_DOUBLE_TIME	LITERAL1
BMC_BEATBUDDY_CC_PART_NUMBER	LITERAL1
BMC_BEATBUDDY_CC_TEMPO_MSB	LITERAL1
BMC_BEATBUDDY_CC_TEMPO_LSB	LITERAL1
BMC_BEATBUDDY_CC_MIX_VOL	LITERAL1
BMC_BEATBUDDY_CC_HP_VOL	LITERAL1
BMC_BEATBUDDY_CC_ACCENT_HIT	LITERAL1
BMC_BEATBUDDY_CC_PAUSE	LITERAL1
BMC_BEATBUDDY_CC_DRUM_FILL	LITERAL1
BMC_BEATBUDDY_CC_TRANSITION	LITERAL1
BMC_BEATBUDDY_CC_START_PLAYBACK	LITERAL1
BMC_BEATBUDDY_CC_OUTRO	LITERAL1
BMC_BEATBUDDY_CC_DRUMSET_SELECT	LITERAL1
BMC_BEATBUDDY_CC_TAP	LITERAL1
BMC_BEATBUDDY_CC_FOLDER_ENTER_EXIT	LITERAL1
BMC_BEATBUDDY_CC_SONG_FOLDER_SCROLL	LITERAL1
BMC_BEATBUDDY_CMD_BPM_INC	LITERAL1
BMC_BEATBUDDY_CMD_BPM_DEC	LITERAL1
BMC_BEATBUDDY_CMD_PAUSE	LITERAL1
BMC_BEATBUDDY_CMD_UNPAUSE	LITERAL1
BMC_BEATBUDDY_CMD_PAUSE_TOGGLE	LITERAL1
BMC_BEATBUDDY_CMD_DRUM_FILL	LITERAL1
BMC_BEATBUDDY_CMD_OUTRO	LITERAL1
BMC_BEATBUDDY_CMD_TAP	LITERAL1
BMC_BEATBUDDY_CMD_MIX_VOL	LITERAL1
BMC_BEATBUDDY_CMD_HP_VOL	LITERAL1
BMC_BEATBUDDY_CMD_ACCENT_HIT	LITERAL1
BMC_BEATBUDDY_CMD_START	LITERAL1
BMC_BEATBUDDY_CMD_STOP	LITERAL1
BMC_BEATBUDDY_CMD_DRUMSET_SELECT	LITERAL1
BMC_BEATBUDDY_CMD_NORMAL_TIME	LITERAL1
BMC_BEATBUDDY_CMD_HALF_TIME	LITERAL1
BMC_BEATBUDDY_CMD_DOUBLE_TIME	LITERAL1
BMC_BEATBUDDY_CMD_FOLDER_ENTER	LITERAL1
BMC_BEATBUDDY_CMD_SONG_SCROLL_DOWN	LITERAL1
BMC_BEATBUDDY_CMD_SONG_SCROLL_UP	LITERAL1
BMC_BEATBUDDY_CMD_HALF_TIME_TOGGLE	LITERAL1
BMC_BEATBUDDY_CMD_DOUBLE_TIME_TOGGLE	LITERAL1
BMC_BEATBUDDY_CMD_TRANS_END	LITERAL1
BMC_BEATBUDDY_CMD_TRANS_PART_1	LITERAL1
BMC_BEATBUDDY_CMD_TRANS_PART_2	LITERAL1
BMC_BEATBUDDY_CMD_TRANS_PART_3	LITERAL1
BMC_BEATBUDDY_CMD_TRANS_PART_4	LITERAL1
BMC_BEATBUDDY_CMD_TRANS_PART_5	LITERAL1
BMC_BEATBUDDY_CMD_TRANS_PART_6	LITERAL1
BMC_BEATBUDDY_CMD_TRANS_PART_7	LITERAL1
BMC_BEATBUDDY_CMD_TRANS_PART_8	LITERAL1
BMC_BEATBUDDY_CMD_TRANS_PART_9	LITERAL1
BMC_BEATBUDDY_CMD_TRANS_PART_10	LITERAL1
BMC_BEATBUDDY_CMD_TRANS_PART_11	LITERAL1
BMC_BEATBUDDY_CMD_TRANS_PART_12	LITERAL1
BMC_BEATBUDDY_CMD_TRANS_PART_13	LITERAL1
BMC_BEATBUDDY_CMD_TRANS_PART_14	LITERAL1
BMC_BEATBUDDY_CMD_TRANS_PART_15	LITERAL1
BMC_BEATBUDDY_CMD_TRANS_PART_16	LITERAL1
BMC_BEATBUDDY_CMD_TRANS_PART_17	LITERAL1
BMC_BEATBUDDY_CMD_TRANS_PART_18	LITERAL1
BMC_BEATBUDDY_CMD_TRANS_PART_19	LITERAL1
BMC_BEATBUDDY_CMD_TRANS_PART_20	LITERAL1
BMC_BEATBUDDY_CMD_TRANS_PART_21	LITERAL1
BMC_BEATBUDDY_CMD_TRANS_PART_22	LITERAL1
BMC_BEATBUDDY_CMD_TRANS_PART_23	LITERAL1
BMC_BEATBUDDY_CMD_TRANS_PART_24	LITERAL1
BMC_BEATBUDDY_CMD_TRANS_PART_25	LITERAL1
BMC_BEATBUDDY_CMD_TRANS_PART_26	LITERAL1
BMC_BEATBUDDY_CMD_TRANS_PART_27	LITERAL1
BMC_BEATBUDDY_CMD_TRANS_PART_28	LITERAL1
BMC_BEATBUDDY_CMD_TRANS_PART_29	LITERAL1
BMC_BEATBUDDY_CMD_TRANS_PART_30	LITERAL1
BMC_BEATBUDDY_CMD_TRANS_PART_31	LITERAL1
BMC_BEATBUDDY_CMD_TRANS_PART_32	LITERAL1
BMC_BEATBUDDY_CMD_TRANS_PART_33	LITERAL1
BMC_BEATBUDDY_CMD_TRANS_PART_34	LITERAL1
BMC_BEATBUDDY_CMD_TRANS_PART_35	LITERAL1
BMC_BEATBUDDY_CMD_TRANS_PART_36	LITERAL1
BMC_BEATBUDDY_CMD_TRANS_PART_37	LITERAL1
BMC_BEATBUDDY_CMD_TRANS_PART_38	LITERAL1
BMC_BEATBUDDY_CMD_TRANS_PART_39	LITERAL1
BMC_BEATBUDDY_CMD_TRANS_PART_40	LITERAL1
BMC_BEATBUDDY_CMD_TRANS_PART_41	LITERAL1
BMC_BEATBUDDY_CMD_TRANS_PART_42	LITERAL1
BMC_BEATBUDDY_CMD_TRANS_PART_43	LITERAL1
BMC_BEATBUDDY_CMD_TRANS_PART_44	LITERAL1
BMC_BEATBUDDY_CMD_TRANS_PART_45	LITERAL1
BMC_BEATBUDDY_CMD_TRANS_PART_46	LITERAL1
BMC_BEATBUDDY_CMD_TRANS_PART_47	LITERAL1
BMC_BEATBUDDY_CMD_TRANS_PART_48	LITERAL1
BMC_BEATBUDDY_CMD_TRANS_PART_49	LITERAL1
BMC_BEATBUDDY_CMD_TRANS_PART_50	LITERAL1
BMC_BEATBUDDY_CMD_TRANS_PART_51	LITERAL1
BMC_BEATBUDDY_CMD_TRANS_PART_52	LITERAL1
BMC_BEATBUDDY_CMD_TRANS_PART_53	LITERAL1
BMC_BEATBUDDY_CMD_TRANS_PART_54	LITERAL1
BMC_BEATBUDDY_CMD_TRANS_PART_55	LITERAL1
BMC_BEATBUDDY_CMD_TRANS_PART_56	LITERAL1
BMC_BEATBUDDY_CMD_TRANS_PART_57	LITERAL1
BMC_BEATBUDDY_CMD_TRANS_PART_58	LITERAL1
BMC_BEATBUDDY_CMD_TRANS_PART_59	LITERAL1
BMC_BEATBUDDY_CMD_TRANS_PART_60	LITERAL1
BMC_BEATBUDDY_CMD_TRANS_PART_61	LITERAL1
BMC_BEATBUDDY_CMD_TRANS_PART_62	LITERAL1
BMC_BEATBUDDY_CMD_TRANS_PART_63	LITERAL1
BMC_BEATBUDDY_CMD_TRANS_PART_64	LITERAL1
BMC_BEATBUDDY_CMD_TRANS_PART_65	LITERAL1
BMC_BEATBUDDY_CMD_TRANS_PART_66	LITERAL1
BMC_BEATBUDDY_CMD_TRANS_PART_67	LITERAL1
BMC_BEATBUDDY_CMD_TRANS_PART_68	LITERAL1
BMC_BEATBUDDY_CMD_TRANS_PART_69	LITERAL1
BMC_BEATBUDDY_CMD_TRANS_PART_70	LITERAL1
BMC_BEATBUDDY_CMD_TRANS_PART_71	LITERAL1
BMC_BEATBUDDY_CMD_TRANS_PART_72	LITERAL1
BMC_BEATBUDDY_CMD_TRANS_PART_73	LITERAL1
BMC_BEATBUDDY_CMD_TRANS_PART_74	LITERAL1
BMC_BEATBUDDY_CMD_TRANS_PART_75	LITERAL1
BMC_BEATBUDDY_CMD_TRANS_PART_76	LITERAL1
BMC_BEATBUDDY_CMD_TRANS_PART_77	LITERAL1
BMC_BEATBUDDY_CMD_TRANS_PART_78	LITERAL1
BMC_BEATBUDDY_CMD_TRANS_PART_79	LITERAL1
BMC_BEATBUDDY_CMD_TRANS_PART_80	LITERAL1
BMC_BEATBUDDY_CMD_TRANS_PART_81	LITERAL1
BMC_BEATBUDDY_CMD_TRANS_PART_82	LITERAL1
BMC_BEATBUDDY_CMD_TRANS_PART_83	LITERAL1
BMC_BEATBUDDY_CMD_TRANS_PART_84	LITERAL1
BMC_BEATBUDDY_CMD_TRANS_PART_85	LITERAL1
BMC_BEATBUDDY_CMD_TRANS_PART_86	LITERAL1
BMC_BEATBUDDY_CMD_TRANS_PART_87	LITERAL1
BMC_BEATBUDDY_CMD_TRANS_PART_88	LITERAL1
BMC_BEATBUDDY_CMD_TRANS_PART_89	LITERAL1
BMC_BEATBUDDY_CMD_TRANS_PART_90	LITERAL1
BMC_BEATBUDDY_CMD_TRANS_PART_91	LITERAL1
BMC_BEATBUDDY_CMD_TRANS_PART_92	LITERAL1
BMC_BEATBUDDY_CMD_TRANS_PART_93	LITERAL1
BMC_BEATBUDDY_CMD_TRANS_PART_94	LITERAL1
BMC_BEATBUDDY_CMD_TRANS_PART_95	LITERAL1
BMC_BEATBUDDY_CMD_TRANS_PART_96	LITERAL1
BMC_BEATBUDDY_CMD_TRANS_PART_97	LITERAL1
BMC_BEATBUDDY_CMD_TRANS_PART_98	LITERAL1
BMC_BEATBUDDY_CMD_TRANS_PART_99	LITERAL1
BMC_BEATBUDDY_CMD_TRANS_PART_100	LITERAL1
BMC_BEATBUDDY_CMD_TRANS_PART_101	LITERAL1
BMC_BEATBUDDY_CMD_TRANS_PART_102	LITERAL1
BMC_BEATBUDDY_CMD_TRANS_PART_103	LITERAL1
BMC_BEATBUDDY_CMD_TRANS_PART_104	LITERAL1
BMC_BEATBUDDY_CMD_TRANS_PART_105	LITERAL1
BMC_BEATBUDDY_CMD_TRANS_PART_106	LITERAL1
BMC_BEATBUDDY_CMD_TRANS_PART_107	LITERAL1
BMC_BEATBUDDY_CMD_TRANS_PART_108	LITERAL1
BMC_BEATBUDDY_CMD_TRANS_PART_109	LITERAL1
BMC_BEATBUDDY_CMD_TRANS_PART_110	LITERAL1
BMC_BEATBUDDY_CMD_TRANS_PART_111	LITERAL1
BMC_BEATBUDDY_CMD_TRANS_PART_112	LITERAL1
BMC_BEATBUDDY_CMD_TRANS_PART_113	LITERAL1
BMC_BEATBUDDY_CMD_TRANS_PART_114	LITERAL1
BMC_BEATBUDDY_CMD_TRANS_PART_115	LITERAL1
BMC_BEATBUDDY_CMD_TRANS_PART_116	LITERAL1
BMC_BEATBUDDY_CMD_TRANS_PART_117	LITERAL1
BMC_BEATBUDDY_CMD_TRANS_PART_118	LITERAL1
BMC_BEATBUDDY_CMD_TRANS_PART_119	LITERAL1
BMC_BEATBUDDY_CMD_TRANS_PART_120	LITERAL1
BMC_BEATBUDDY_CMD_TRANS_PART_121	LITERAL1
BMC_BEATBUDDY_CMD_TRANS_PART_122	LITERAL1
BMC_BEATBUDDY_CMD_TRANS_PART_123	LITERAL1
BMC_BEATBUDDY_CMD_TRANS_PART_124	LITERAL1
BMC_BEATBUDDY_CMD_TRANS_PART_125	LITERAL1
BMC_BEATBUDDY_CMD_TRANS_PREV	LITERAL1
BMC_BEATBUDDY_CMD_TRANS_NEXT	LITERAL1
BMC_HELIX_ID	LITERAL1
BMC_HELIX_FX_ID	LITERAL1
BMC_HELIX_STOMP_ID	LITERAL1
BMC_HELIX_CC_TAP	LITERAL1
BMC_HELIX_CC_TUNER	LITERAL1
BMC_HELIX_CC_SNAPSHOT	LITERAL1
BMC_HELIX_CMD_TAP	LITERAL1
BMC_HELIX_CMD_TUNER	LITERAL1
BMC_HELIX_CMD_SNAPSHOT	LITERAL1
BMC_HELIX_CMD_SNAPSHOT_TOGGLE	LITERAL1
BMC_HELIX_CMD_SNAPSHOT_INC	LITERAL1
BMC_HELIX_CMD_SNAPSHOT_DEC	LITERAL1
BMC_EVENT_TYPE_CUSTOM	LITERAL1
BMC_BUTTON_EVENT_TYPE_PAGE	LITERAL1
BMC_BUTTON_EVENT_TYPE_PAGE_SCROLL	LITERAL1
BMC_BUTTON_EVENT_TYPE_PROGRAM_SCROLL	LITERAL1
BMC_BUTTON_EVENT_TYPE_CONTROL_SCROLL	LITERAL1
BMC_BUTTON_EVENT_TYPE_CONTROL_TOGGLE	LITERAL1
BMC_BUTTON_EVENT_TYPE_MASTER_CLOCK_TAP	LITERAL1
BMC_BUTTON_EVENT_TYPE_MASTER_CLOCK_SET	LITERAL1
BMC_BUTTON_EVENT_TYPE_LIBRARY	LITERAL1
BMC_BUTTON_EVENT_TYPE_LIBRARY2	LITERAL1
BMC_BUTTON_EVENT_TYPE_LIBRARY3	LITERAL1
BMC_BUTTON_EVENT_TYPE_PRESET	LITERAL1
BMC_BUTTON_EVENT_TYPE_PRESET_SCROLL	LITERAL1
BMC_BUTTON_EVENT_TYPE_CUSTOM_SYSEX	LITERAL1
BMC_BUTTON_EVENT_TYPE_BEATBUDDY_SET_BPM	LITERAL1
BMC_BUTTON_EVENT_TYPE_BEATBUDDY_CMD	LITERAL1
BMC_BUTTON_EVENT_TYPE_BEATBUDDY_FOLDER_SONG	LITERAL1
BMC_BUTTON_EVENT_TYPE_CLICK_TRACK	LITERAL1
BMC_BUTTON_EVENT_TYPE_BANK_MSB_PROGRAM	LITERAL1
BMC_BUTTON_EVENT_TYPE_BANK_LSB_PROGRAM	LITERAL1
BMC_BUTTON_EVENT_TYPE_BANK_MSB_LSB	LITERAL1
BMC_BUTTON_EVENT_TYPE_HELIX_CMD	LITERAL1
BMC_BUTTON_EVENT_TYPE_ACTIVE_SENSE	LITERAL1
BMC_BUTTON_EVENT_TYPE_NL_RELAY_CONTROL	LITERAL1
BMC_BUTTON_EVENT_TYPE_L_RELAY_CONTROL	LITERAL1
BMC_BUTTON_EVENT_TYPE_SKETCH_BYTE_SET	LITERAL1
BMC_BUTTON_EVENT_TYPE_SKETCH_BYTE_SCROLL	LITERAL1
BMC_BUTTON_EVENT_TYPE_SKETCH_BYTE_TOGGLE	LITERAL1
BMC_BUTTON_EVENT_TYPE_LED_TEMP_BLINK	LITERAL1
BMC_BUTTON_EVENT_TYPE_GLOBAL_LED_TEMP_BLINK	LITERAL1
BMC_BUTTON_EVENT_TYPE_CONTROL_TOGGLE_2	LITERAL1
BMC_BUTTON_EVENT_TYPE_TMP_SCROLLER_TRIGGER	LITERAL1
BMC_BUTTON_EVENT_TYPE_TMP_SCROLLER_PAGES	LITERAL1
BMC_BUTTON_EVENT_TYPE_TMP_SCROLLER_PRESETS	LITERAL1
BMC_BUTTON_EVENT_TYPE_NL_RELAY_CONTROL_TOGGLE	LITERAL1
BMC_BUTTON_EVENT_TYPE_L_RELAY_CONTROL_TOGGLE	LITERAL1
BMC_BUTTON_EVENT_TYPE_MIDI_REAL_TIME_BLOCK	LITERAL1
BMC_BUTTON_EVENT_TYPE_STOPWATCH	LITERAL1
BMC_BUTTON_EVENT_TYPE_BLE_DISCONNECT	LITERAL1
BMC_BUTTON_EVENT_TYPE_PWM_LED_TEMP_BLINK	LITERAL1
BMC_BUTTON_EVENT_TYPE_PRESET_IN_BANK	LITERAL1
BMC_BUTTON_EVENT_TYPE_PRESET_IN_BANK_SCROLL	LITERAL1
BMC_BUTTON_EVENT_TYPE_PRESETS_SET_BANK	LITERAL1
BMC_BUTTON_EVENT_TYPE_PRESETS_BANK_SCROLL	LITERAL1
BMC_BUTTON_EVENT_TYPE_SETLIST	LITERAL1
BMC_BUTTON_EVENT_TYPE_SETLIST_SCROLL	LITERAL1
BMC_BUTTON_EVENT_TYPE_SETLIST_SONG	LITERAL1
BMC_BUTTON_EVENT_TYPE_SETLIST_SONG_SCROLL	LITERAL1
BMC_BUTTON_EVENT_TYPE_PROGRAM_BANKING_SCROLL	LITERAL1
BMC_BUTTON_EVENT_TYPE_PROGRAM_BANKING_TRIGGER	LITERAL1
BMC_BUTTON_EVENT_TYPE_FAS_COMMAND	LITERAL1
BMC_BUTTON_EVENT_TYPE_FAS_PRESET	LITERAL1
BMC_BUTTON_EVENT_TYPE_FAS_PRESET_SCROLL	LITERAL1
BMC_BUTTON_EVENT_TYPE_FAS_SCENE	LITERAL1
BMC_BUTTON_EVENT_TYPE_FAS_SCENE_SCROLL	LITERAL1
BMC_BUTTON_EVENT_TYPE_FAS_BLOCK_STATE	LITERAL1
BMC_BUTTON_EVENT_TYPE_FAS_BLOCK_PARAM	LITERAL1
BMC_BUTTON_EVENT_TYPE_KEMPER_COMMAND	LITERAL1
BMC_BUTTON_EVENT_TYPE_KEMPER_RIG	LITERAL1
BMC_BUTTON_EVENT_TYPE_KEMPER_STOMP	LITERAL1
BMC_BUTTON_EVENT_TYPE_KEMPER_RESERVED1	LITERAL1
BMC_BUTTON_EVENT_TYPE_KEMPER_RESERVED2	LITERAL1
BMC_BUTTON_EVENT_TYPE_SAVE_EEPROM	LITERAL1
BMC_BUTTON_EVENT_TYPE_MENU	LITERAL1
BMC_BUTTON_EVENT_TYPE_DELAY	LITERAL1
BMC_BUTTON_EVENT_TYPE_CUSTOM	LITERAL1
BMC_LED_EVENT_TYPE_MIDI_ACTIVITY	LITERAL1
BMC_LED_EVENT_TYPE_CLOCK_SYNC	LITERAL1
BMC_LED_EVENT_TYPE_STATUS	LITERAL1
BMC_LED_EVENT_TYPE_PAGE	LITERAL1
BMC_LED_EVENT_TYPE_PRESET	LITERAL1
BMC_LED_EVENT_TYPE_BUTTON	LITERAL1
BMC_LED_EVENT_TYPE_GLOBAL_BUTTON	LITERAL1
BMC_LED_EVENT_TYPE_POT	LITERAL1
BMC_LED_EVENT_TYPE_NL_RELAY	LITERAL1
BMC_LED_EVENT_TYPE_L_RELAY	LITERAL1
BMC_LED_EVENT_TYPE_AUX_JACK_CONNECTED	LITERAL1
BMC_LED_EVENT_TYPE_BEATBUDDY	LITERAL1
BMC_LED_EVENT_TYPE_HELIX_SNAPSHOT	LITERAL1
BMC_LED_EVENT_TYPE_PRESET_IN_BANK	LITERAL1
BMC_LED_EVENT_TYPE_PRESETS_BANK	LITERAL1
BMC_LED_EVENT_TYPE_SETLIST	LITERAL1
BMC_LED_EVENT_TYPE_SETLIST_SONG	LITERAL1
BMC_LED_EVENT_TYPE_GLOBAL_POT	LITERAL1
BMC_LED_EVENT_TYPE_FAS_STATE	LITERAL1
BMC_LED_EVENT_TYPE_FAS_PRESET	LITERAL1
BMC_LED_EVENT_TYPE_FAS_SCENE	LITERAL1
BMC_LED_EVENT_TYPE_FAS_BLOCK_STATE	LITERAL1
BMC_LED_EVENT_TYPE_KEMPER_STATE	LITERAL1
BMC_LED_EVENT_TYPE_KEMPER_RIG	LITERAL1
BMC_LED_EVENT_TYPE_KEMPER_STOMP	LITERAL1
BMC_LED_EVENT_TYPE_KEMPER_RESERVED	LITERAL1
BMC_LED_STATUS_BMC	LITERAL1
BMC_LED_STATUS_ALWAYS_ON	LITERAL1
BMC_LED_STATUS_EDITOR_CONNECTED	LITERAL1
BMC_LED_STATUS_HOST_CONNECTED	LITERAL1
BMC_LED_STATUS_BLE_CONNECTED	LITERAL1
BMC_LED_STATUS_ACTIVE_SENSE_SENDING	LITERAL1
BMC_LED_STATUS_ACTIVE_SENSE_READING	LITERAL1
BMC_LED_STATUS_MIDI_REAL_TIME_BLOCK_INPUT	LITERAL1
BMC_LED_STATUS_MIDI_REAL_TIME_BLOCK_OUTPUT	LITERAL1
BMC_LED_STATUS_STOPWATCH_STATE	LITERAL1
BMC_LED_STATUS_STOPWATCH_ACTIVE	LITERAL1
BMC_LED_STATUS_STOPWATCH_COMPLETE	LITERAL1
BMC_LED_BEATBUDDY_SYNC	LITERAL1
BMC_LED_BEATBUDDY_PLAYING	LITERAL1
BMC_LED_BEATBUDDY_PART	LITERAL1
BMC_LED_BEATBUDDY_HALF_TIME	LITERAL1
BMC_LED_BEATBUDDY_DOUBLE_TIME	LITERAL1
BMC_COLOR_BLACK	LITERAL1
BMC_COLOR_RED	LITERAL1
BMC_COLOR_GREEN	LITERAL1
BMC_COLOR_YELLOW	LITERAL1
BMC_COLOR_BLUE	LITERAL1
BMC_COLOR_MAGENTA	LITERAL1
BMC_COLOR_CYAN	LITERAL1
BMC_COLOR_WHITE	LITERAL1
BMC_COLOR_LIME	LITERAL1
BMC_COLOR_PINK	LITERAL1
BMC_COLOR_PURPLE	LITERAL1
BMC_COLOR_ORANGE	LITERAL1
BMC_COLOR_TEAL	LITERAL1
BMC_COLOR_CORAL	LITERAL1
BMC_COLOR_LIGHT_BLUE	LITERAL1
BMC_COLOR_RAINBOW	LITERAL1
BMC_PIXEL_BLACK	LITERAL1
BMC_PIXEL_RAINBOW	LITERAL1
BMC_PIXEL_RED	LITERAL1
BMC_PIXEL_GREEN	LITERAL1
BMC_PIXEL_BLUE	LITERAL1
BMC_PIXEL_YELLOW	LITERAL1
BMC_PIXEL_MAGENTA	LITERAL1
BMC_PIXEL_LIME	LITERAL1
BMC_PIXEL_CYAN	LITERAL1
BMC_PIXEL_PINK	LITERAL1
BMC_PIXEL_PURPLE	LITERAL1
BMC_PIXEL_LIGHT_BLUE	LITERAL1
BMC_PIXEL_ORANGE	LITERAL1
BMC_PIXEL_CORAL	LITERAL1
BMC_PIXEL_TEAL	LITERAL1
BMC_PIXEL_WHITE	LITERAL1
BMC_KEMPER_CC_TOGGLE_ALL_STOMPS	LITERAL1
BMC_KEMPER_CC_TOGGLE_STOP_A	LITERAL1
BMC_KEMPER_CC_TOGGLE_STOP_B	LITERAL1
BMC_KEMPER_CC_TOGGLE_STOP_C	LITERAL1
BMC_KEMPER_CC_TOGGLE_STOP_D	LITERAL1
BMC_KEMPER_CC_TOGGLE_STOP_X	LITERAL1
BMC_KEMPER_CC_TOGGLE_STOP_MOD	LITERAL1
BMC_KEMPER_CC_TOGGLE_STOP_DELAY	LITERAL1
BMC_KEMPER_CC_TOGGLE_STOP_DELAY_TAIL	LITERAL1
BMC_KEMPER_CC_TOGGLE_REVERB	LITERAL1
BMC_KEMPER_CC_TOGGLE_REVER_TAIL	LITERAL1
BMC_KEMPER_CC_SET_TEMPO	LITERAL1
BMC_KEMPER_CC_TUNER	LITERAL1
BMC_KEMPER_CC_ROTARY_SPEAKER_SPEED	LITERAL1
BMC_KEMPER_CC_DELAY_FEEDBACK_INFINITY	LITERAL1
BMC_KEMPER_CC_DELAY_HOLD	LITERAL1
BMC_KEMPER_CC_PM_PRESELECTED_INDEX	LITERAL1
BMC_KEMPER_CC_NEXT_RIG	LITERAL1
BMC_KEMPER_CC_PREV_RIG	LITERAL1
BMC_KEMPER_CC_FIRST_RIG	LITERAL1
BMC_KEMPER_CC_SECOND_RIG	LITERAL1
BMC_KEMPER_CC_THIRD_RIG	LITERAL1
BMC_KEMPER_CC_FOURTH_RIG	LITERAL1
BMC_KEMPER_CC_FIFTH_RIG	LITERAL1
BMC_KEMPER_CC_DELAY_MIX	LITERAL1
BMC_KEMPER_CC_DELAY_FEEDBACK	LITERAL1
BMC_KEMPER_CC_REVERB_MIX	LITERAL1
BMC_KEMPER_CC_REVERB_TIME	LITERAL1
BMC_KEMPER_CC_AMP_GAIN	LITERAL1
BMC_KEMPER_CC_GLOBAL_MONITOR_OUT_LEVEL	LITERAL1
BMC_KEMPER_PARAM_RIG_TEMPO	LITERAL1
BMC_KEMPER_PARAM_RIG_VOLUME	LITERAL1
BMC_KEMPER_PARAM_RIG_TEMPO_ENABLE	LITERAL1
BMC_KEMPER_PARAM_INPUT_NOISE_GATE_INTENSITY	LITERAL1
BMC_KEMPER_PARAM_INPUT_CLEAN_SENSE	LITERAL1
BMC_KEMPER_PARAM_INPUT_DISTORTION_SENSE	LITERAL1
BMC_KEMPER_PARAM_AMPLIFIER_ON_OFF	LITERAL1
BMC_KEMPER_PARAM_AMPLIFIER_GAIN	LITERAL1
BMC_KEMPER_PARAM_AMPLIFIER_DEFINITION	LITERAL1
BMC_KEMPER_PARAM_AMPLIFIER_CLARITY	LITERAL1
BMC_KEMPER_PARAM_AMPLIFIER_POWER_SAGGING_	LITERAL1
BMC_KEMPER_PARAM_AMPLIFIER_PICK	LITERAL1
BMC_KEMPER_PARAM_AMPLIFIER_COMPRESSOR_	LITERAL1
BMC_KEMPER_PARAM_AMPLIFIER_TUBE_SHAPE_	LITERAL1
BMC_KEMPER_PARAM_AMPLIFIER_TUBE_BIAS	LITERAL1
BMC_KEMPER_PARAM_AMPLIFIER_DIRECT_MIX	LITERAL1
BMC_KEMPER_PARAM_EQUALIZER_ON_OFF	LITERAL1
BMC_KEMPER_PARAM_EQUALIZER_BASS	LITERAL1
BMC_KEMPER_PARAM_EQUALIZER_MIDDLE	LITERAL1
BMC_KEMPER_PARAM_EQUALIZER_TREBLE	LITERAL1
BMC_KEMPER_PARAM_EQUALIZER_PRESENCE	LITERAL1
BMC_KEMPER_PARAM_CABINET_ON_OFF	LITERAL1
BMC_KEMPER_PARAM_CABINET_VOLUME	LITERAL1
BMC_KEMPER_PARAM_CABINET_HIGH_SHIFT	LITERAL1
BMC_KEMPER_PARAM_CABINET_LOW_SHIFT	LITERAL1
BMC_KEMPER_PARAM_CABINET_CHARACTER	LITERAL1
BMC_KEMPER_PARAM_CABINET_PURE_CABINET__RIG_	LITERAL1
BMC_KEMPER_PARAM_STOMP_A_TYPE	LITERAL1
BMC_KEMPER_PARAM_STOMP_A_ON_OFF_4_MIX	LITERAL1
BMC_KEMPER_PARAM_STOMP_A_VOLUME_7_STEREO	LITERAL1
BMC_KEMPER_PARAM_STOMP_A_WAH_MANUAL	LITERAL1
BMC_KEMPER_PARAM_STOMP_A_WAH_PEAK	LITERAL1
BMC_KEMPER_PARAM_STOMP_A_WAH_RANGE	LITERAL1
BMC_KEMPER_PARAM_STOMP_A_WAH_PEDAL_MODE_	LITERAL1
BMC_KEMPER_PARAM_STOMP_A_WAH_TOUCH_ATTACK_	LITERAL1
BMC_KEMPER_PARAM_STOMP_A_WAH_TOUCH_RELEASE_	LITERAL1
BMC_KEMPER_PARAM_STOMP_A_WAH_TOUCH_BOOST	LITERAL1
BMC_KEMPER_PARAM_STOMP_A_DISTORTION_SHAPER_DRIVE_	LITERAL1
BMC_KEMPER_PARAM_STOMP_A_DISTORTION_BOOSTER_TONE	LITERAL1
BMC_KEMPER_PARAM_STOMP_A_COMPRESSOR_GATE_INTENSITY_	LITERAL1
BMC_KEMPER_PARAM_STOMP_A_COMPRESSOR_ATTACK	LITERAL1
BMC_KEMPER_PARAM_STOMP_A_MODULATION_RATE	LITERAL1
BMC_KEMPER_PARAM_STOMP_A_MODULATION_DEPTH	LITERAL1
BMC_KEMPER_PARAM_STOMP_A_MODULATION_FEEDBACK	LITERAL1
BMC_KEMPER_PARAM_STOMP_A_MODULATION_CROSSOVER	LITERAL1
BMC_KEMPER_PARAM_STOMP_A_MODULATION_HYPERCHORUS_AMOUNT_	LITERAL1
BMC_KEMPER_PARAM_STOMP_A_MODULATION_MANUAL	LITERAL1
BMC_KEMPER_PARAM_STOMP_A_MODULATION_PHASER_PEAK_SPREAD_	LITERAL1
BMC_KEMPER_PARAM_STOMP_A_MODULATION_PHASER_STAGES	LITERAL1
BMC_KEMPER_PARAM_STOMP_A_ROTARY_SPEED__SLOW_FAST__	LITERAL1
BMC_KEMPER_PARAM_STOMP_A_ROTARY_DISTANCE	LITERAL1
BMC_KEMPER_PARAM_STOMP_A_ROTARY_BALANCE	LITERAL1
BMC_KEMPER_PARAM_STOMP_A_COMPRESSOR_SQUASH	LITERAL1
BMC_KEMPER_PARAM_STOMP_A_GRAPHIC_EQ_BAND_1_	LITERAL1
BMC_KEMPER_PARAM_STOMP_A_GRAPHIC_EQ_BAND_2_	LITERAL1
BMC_KEMPER_PARAM_STOMP_A_GRAPHIC_EQ_BAND_3_	LITERAL1
BMC_KEMPER_PARAM_STOMP_A_GRAPHIC_EQ_BAND_4_	LITERAL1
BMC_KEMPER_PARAM_STOMP_A_GRAPHIC_EQ_BAND_5_	LITERAL1
BMC_KEMPER_PARAM_STOMP_A_GRAPHIC_EQ_BAND_6_	LITERAL1
BMC_KEMPER_PARAM_STOMP_A_GRAPHIC_EQ_BAND_7_	LITERAL1
BMC_KEMPER_PARAM_STOMP_A_GRAPHIC_EQ_BAND_8	LITERAL1
BMC_KEMPER_PARAM_STOMP_A_PARAMETRIC_EQ_LOW_GAIN	LITERAL1
BMC_KEMPER_PARAM_STOMP_A_PARAMETRIC_EQ_LOW_FREQUENCY_	LITERAL1
BMC_KEMPER_PARAM_STOMP_A_PARAMETRIC_EQ_HIGH_GAIN	LITERAL1
BMC_KEMPER_PARAM_STOMP_A_PARAMETRIC_EQ_HIGH_FREQUENCY_	LITERAL1
BMC_KEMPER_PARAM_STOMP_A_PARAMETRIC_EQ_PEAK_GAIN	LITERAL1
BMC_KEMPER_PARAM_STOMP_A_PARAMETRIC_EQ_PEAK_FREQUENCY_	LITERAL1
BMC_KEMPER_PARAM_STOMP_A_PARAMETRIC_EQ_PEAK_Q_FACTOR	LITERAL1
BMC_KEMPER_PARAM_STOMP_A_PARAMETRIC_EQ_PEAK_GAIN_2	LITERAL1
BMC_KEMPER_PARAM_STOMP_A_PARAMETRIC_EQ_PEAK_FREQUENCY_2_	LITERAL1
BMC_KEMPER_PARAM_STOMP_A_PARAMETRIC_EQ_PEAK_Q_FACTOR_2	LITERAL1
BMC_KEMPER_PARAM_STOMP_A_WAH_PEAK_RANGE_	LITERAL1
BMC_KEMPER_PARAM_STOMP_A_DUCKING	LITERAL1
BMC_KEMPER_PARAM_STOMP_A_VOICE_MIX_	LITERAL1
BMC_KEMPER_PARAM_STOMP_A_VOICE_1_PITCH_	LITERAL1
BMC_KEMPER_PARAM_STOMP_A_VOICE_2_PITCH_	LITERAL1
BMC_KEMPER_PARAM_STOMP_A_DETUNE	LITERAL1
BMC_KEMPER_PARAM_STOMP_A_SMOOTH_CHORDS_	LITERAL1
BMC_KEMPER_PARAM_STOMP_A_PURE_TUNING	LITERAL1
BMC_KEMPER_PARAM_STOMP_A_KEY	LITERAL1
BMC_KEMPER_PARAM_STOMP_A_FREEZE_FORMANTS_	LITERAL1
BMC_KEMPER_PARAM_STOMP_A_FORMANT_OFFSET_	LITERAL1
BMC_KEMPER_PARAM_STOMP_A_LOW_CUT	LITERAL1
BMC_KEMPER_PARAM_STOMP_A_HIGH_CUT	LITERAL1
BMC_KEMPER_PARAM_STOMP_A_DELAY_MIX	LITERAL1
BMC_KEMPER_PARAM_STOMP_A_DELAY_MIX_PRE_POST_	LITERAL1
BMC_KEMPER_PARAM_STOMP_A_DELAY_TIME_1	LITERAL1
BMC_KEMPER_PARAM_STOMP_A_DELAY_TIME_2	LITERAL1
BMC_KEMPER_PARAM_STOMP_A_DELAY_RATIO_2	LITERAL1
BMC_KEMPER_PARAM_STOMP_A_DELAY_RATIO_3	LITERAL1
BMC_KEMPER_PARAM_STOMP_A_DELAY_RATIO_4	LITERAL1
BMC_KEMPER_PARAM_STOMP_A_DELAY_NOTE_VALUE_1_	LITERAL1
BMC_KEMPER_PARAM_STOMP_A_DELAY_NOTE_VALUE_2_	LITERAL1
BMC_KEMPER_PARAM_STOMP_A_DELAY_NOTE_VALUE_3_	LITERAL1
BMC_KEMPER_PARAM_STOMP_A_DELAY_NOTE_VALUE_4_	LITERAL1
BMC_KEMPER_PARAM_STOMP_A_TO_TEMPO	LITERAL1
BMC_KEMPER_PARAM_STOMP_A_DELAY_VOLUME_1	LITERAL1
BMC_KEMPER_PARAM_STOMP_A_DELAY_VOLUME_2	LITERAL1
BMC_KEMPER_PARAM_STOMP_A_DELAY_VOLUME_3	LITERAL1
BMC_KEMPER_PARAM_STOMP_A_DELAY_VOLUME_4	LITERAL1
BMC_KEMPER_PARAM_STOMP_A_DELAY_PANORAMA_1	LITERAL1
BMC_KEMPER_PARAM_STOMP_A_DELAY_PANORAMA_2	LITERAL1
BMC_KEMPER_PARAM_STOMP_A_DELAY_PANORAMA_3	LITERAL1
BMC_KEMPER_PARAM_STOMP_A_DELAY_PANORAMA_4	LITERAL1
BMC_KEMPER_PARAM_STOMP_A_VOICE3_PITCH	LITERAL1
BMC_KEMPER_PARAM_STOMP_A_VOICE4_PITCH	LITERAL1
BMC_KEMPER_PARAM_STOMP_A_VOICE3_INTERVAL	LITERAL1
BMC_KEMPER_PARAM_STOMP_A_VOICE4_INTERVAL	LITERAL1
BMC_KEMPER_PARAM_STOMP_A_FEEDBACK	LITERAL1
BMC_KEMPER_PARAM_STOMP_A_INFINITY_FEEDBACK	LITERAL1
BMC_KEMPER_PARAM_STOMP_A_INFINITY	LITERAL1
BMC_KEMPER_PARAM_STOMP_A_FEEDBACK2	LITERAL1
BMC_KEMPER_PARAM_STOMP_A_FEEDBACK_SYNC_SWITCH_	LITERAL1
BMC_KEMPER_PARAM_STOMP_A_DELAY_LOW_CUT	LITERAL1
BMC_KEMPER_PARAM_STOMP_A_DELAY_HIGH_CUT	LITERAL1
BMC_KEMPER_PARAM_STOMP_A_DELAY_FILTER_INTENSITY_	LITERAL1
BMC_KEMPER_PARAM_STOMP_A_DELAY_MODULATION_	LITERAL1
BMC_KEMPER_PARAM_STOMP_A_DELAY_CHORUS	LITERAL1
BMC_KEMPER_PARAM_STOMP_A_FLUTTER_INTENSITY	LITERAL1
BMC_KEMPER_PARAM_STOMP_A_FLUTTER_SHAPE	LITERAL1
BMC_KEMPER_PARAM_STOMP_A_GRIT	LITERAL1
BMC_KEMPER_PARAM_STOMP_A_REVERSE_MIX	LITERAL1
BMC_KEMPER_PARAM_STOMP_A_SWELL	LITERAL1
BMC_KEMPER_PARAM_STOMP_A_SMEAR	LITERAL1
BMC_KEMPER_PARAM_STOMP_A_DUCKING_PRE_POST	LITERAL1
BMC_KEMPER_PARAM_STOMP_B_TYPE	LITERAL1
BMC_KEMPER_PARAM_STOMP_B_ON_OFF_4_MIX	LITERAL1
BMC_KEMPER_PARAM_STOMP_B_VOLUME_7_STEREO	LITERAL1
BMC_KEMPER_PARAM_STOMP_B_WAH_MANUAL	LITERAL1
BMC_KEMPER_PARAM_STOMP_B_WAH_PEAK	LITERAL1
BMC_KEMPER_PARAM_STOMP_B_WAH_RANGE	LITERAL1
BMC_KEMPER_PARAM_STOMP_B_WAH_PEDAL_MODE_	LITERAL1
BMC_KEMPER_PARAM_STOMP_B_WAH_TOUCH_ATTACK_	LITERAL1
BMC_KEMPER_PARAM_STOMP_B_WAH_TOUCH_RELEASE_	LITERAL1
BMC_KEMPER_PARAM_STOMP_B_WAH_TOUCH_BOOST	LITERAL1
BMC_KEMPER_PARAM_STOMP_B_DISTORTION_SHAPER_DRIVE_	LITERAL1
BMC_KEMPER_PARAM_STOMP_B_DISTORTION_BOOSTER_TONE	LITERAL1
BMC_KEMPER_PARAM_STOMP_B_COMPRESSOR_GATE_INTENSITY_	LITERAL1
BMC_KEMPER_PARAM_STOMP_B_COMPRESSOR_ATTACK	LITERAL1
BMC_KEMPER_PARAM_STOMP_B_MODULATION_RATE	LITERAL1
BMC_KEMPER_PARAM_STOMP_B_MODULATION_DEPTH	LITERAL1
BMC_KEMPER_PARAM_STOMP_B_MODULATION_FEEDBACK	LITERAL1
BMC_KEMPER_PARAM_STOMP_B_MODULATION_CROSSOVER	LITERAL1
BMC_KEMPER_PARAM_STOMP_B_MODULATION_HYPERCHORUS_AMOUNT_	LITERAL1
BMC_KEMPER_PARAM_STOMP_B_MODULATION_MANUAL	LITERAL1
BMC_KEMPER_PARAM_STOMP_B_MODULATION_PHASER_PEAK_SPREAD_	LITERAL1
BMC_KEMPER_PARAM_STOMP_B_MODULATION_PHASER_STAGES	LITERAL1
BMC_KEMPER_PARAM_STOMP_B_ROTARY_SPEED__SLOW_FAST__	LITERAL1
BMC_KEMPER_PARAM_STOMP_B_ROTARY_DISTANCE	LITERAL1
BMC_KEMPER_PARAM_STOMP_B_ROTARY_BALANCE	LITERAL1
BMC_KEMPER_PARAM_STOMP_B_COMPRESSOR_SQUASH	LITERAL1
BMC_KEMPER_PARAM_STOMP_B_GRAPHIC_EQ_BAND_1_	LITERAL1
BMC_KEMPER_PARAM_STOMP_B_GRAPHIC_EQ_BAND_2_	LITERAL1
BMC_KEMPER_PARAM_STOMP_B_GRAPHIC_EQ_BAND_3_	LITERAL1
BMC_KEMPER_PARAM_STOMP_B_GRAPHIC_EQ_BAND_4_	LITERAL1
BMC_KEMPER_PARAM_STOMP_B_GRAPHIC_EQ_BAND_5_	LITERAL1
BMC_KEMPER_PARAM_STOMP_B_GRAPHIC_EQ_BAND_6_	LITERAL1
BMC_KEMPER_PARAM_STOMP_B_GRAPHIC_EQ_BAND_7_	LITERAL1
BMC_KEMPER_PARAM_STOMP_B_GRAPHIC_EQ_BAND_8	LITERAL1
BMC_KEMPER_PARAM_STOMP_B_PARAMETRIC_EQ_LOW_GAIN	LITERAL1
BMC_KEMPER_PARAM_STOMP_B_PARAMETRIC_EQ_LOW_FREQUENCY_	LITERAL1
BMC_KEMPER_PARAM_STOMP_B_PARAMETRIC_EQ_HIGH_GAIN	LITERAL1
BMC_KEMPER_PARAM_STOMP_B_PARAMETRIC_EQ_HIGH_FREQUENCY_	LITERAL1
BMC_KEMPER_PARAM_STOMP_B_PARAMETRIC_EQ_PEAK_GAIN	LITERAL1
BMC_KEMPER_PARAM_STOMP_B_PARAMETRIC_EQ_PEAK_FREQUENCY_	LITERAL1
BMC_KEMPER_PARAM_STOMP_B_PARAMETRIC_EQ_PEAK_Q_FACTOR	LITERAL1
BMC_KEMPER_PARAM_STOMP_B_PARAMETRIC_EQ_PEAK_GAIN_2	LITERAL1
BMC_KEMPER_PARAM_STOMP_B_PARAMETRIC_EQ_PEAK_FREQUENCY_2_	LITERAL1
BMC_KEMPER_PARAM_STOMP_B_PARAMETRIC_EQ_PEAK_Q_FACTOR_2	LITERAL1
BMC_KEMPER_PARAM_STOMP_B_WAH_PEAK_RANGE_	LITERAL1
BMC_KEMPER_PARAM_STOMP_B_DUCKING	LITERAL1
BMC_KEMPER_PARAM_STOMP_B_VOICE_MIX_	LITERAL1
BMC_KEMPER_PARAM_STOMP_B_VOICE_1_PITCH_	LITERAL1
BMC_KEMPER_PARAM_STOMP_B_VOICE_2_PITCH_	LITERAL1
BMC_KEMPER_PARAM_STOMP_B_DETUNE	LITERAL1
BMC_KEMPER_PARAM_STOMP_B_SMOOTH_CHORDS_	LITERAL1
BMC_KEMPER_PARAM_STOMP_B_PURE_TUNING	LITERAL1
BMC_KEMPER_PARAM_STOMP_B_KEY	LITERAL1
BMC_KEMPER_PARAM_STOMP_B_FREEZE_FORMANTS_	LITERAL1
BMC_KEMPER_PARAM_STOMP_B_FORMANT_OFFSET_	LITERAL1
BMC_KEMPER_PARAM_STOMP_B_LOW_CUT	LITERAL1
BMC_KEMPER_PARAM_STOMP_B_HIGH_CUT	LITERAL1
BMC_KEMPER_PARAM_STOMP_B_DELAY_MIX	LITERAL1
BMC_KEMPER_PARAM_STOMP_B_DELAY_MIX_PRE_POST_	LITERAL1
BMC_KEMPER_PARAM_STOMP_B_DELAY_TIME_1	LITERAL1
BMC_KEMPER_PARAM_STOMP_B_DELAY_TIME_2	LITERAL1
BMC_KEMPER_PARAM_STOMP_B_DELAY_RATIO_2	LITERAL1
BMC_KEMPER_PARAM_STOMP_B_DELAY_RATIO_3	LITERAL1
BMC_KEMPER_PARAM_STOMP_B_DELAY_RATIO_4	LITERAL1
BMC_KEMPER_PARAM_STOMP_B_DELAY_NOTE_VALUE_1_	LITERAL1
BMC_KEMPER_PARAM_STOMP_B_DELAY_NOTE_VALUE_2_	LITERAL1
BMC_KEMPER_PARAM_STOMP_B_DELAY_NOTE_VALUE_3_	LITERAL1
BMC_KEMPER_PARAM_STOMP_B_DELAY_NOTE_VALUE_4_	LITERAL1
BMC_KEMPER_PARAM_STOMP_B_TO_TEMPO	LITERAL1
BMC_KEMPER_PARAM_STOMP_B_DELAY_VOLUME_1	LITERAL1
BMC_KEMPER_PARAM_STOMP_B_DELAY_VOLUME_2	LITERAL1
BMC_KEMPER_PARAM_STOMP_B_DELAY_VOLUME_3	LITERAL1
BMC_KEMPER_PARAM_STOMP_B_DELAY_VOLUME_4	LITERAL1
BMC_KEMPER_PARAM_STOMP_B_DELAY_PANORAMA_1	LITERAL1
BMC_KEMPER_PARAM_STOMP_B_DELAY_PANORAMA_2	LITERAL1
BMC_KEMPER_PARAM_STOMP_B_DELAY_PANORAMA_3	LITERAL1
BMC_KEMPER_PARAM_STOMP_B_DELAY_PANORAMA_4	LITERAL1
BMC_KEMPER_PARAM_STOMP_B_VOICE3_PITCH	LITERAL1
BMC_KEMPER_PARAM_STOMP_B_VOICE4_PITCH	LITERAL1
BMC_KEMPER_PARAM_STOMP_B_VOICE3_INTERVAL	LITERAL1
BMC_KEMPER_PARAM_STOMP_B_VOICE4_INTERVAL	LITERAL1
BMC_KEMPER_PARAM_STOMP_B_FEEDBACK	LITERAL1
BMC_KEMPER_PARAM_STOMP_B_INFINITY_FEEDBACK	LITERAL1
BMC_KEMPER_PARAM_STOMP_B_INFINITY	LITERAL1
BMC_KEMPER_PARAM_STOMP_B_FEEDBACK2	LITERAL1
BMC_KEMPER_PARAM_STOMP_B_FEEDBACK_SYNC_SWITCH_	LITERAL1
BMC_KEMPER_PARAM_STOMP_B_DELAY_LOW_CUT	LITERAL1
BMC_KEMPER_PARAM_STOMP_B_DELAY_HIGH_CUT	LITERAL1
BMC_KEMPER_PARAM_STOMP_B_DELAY_FILTER_INTENSITY_	LITERAL1
BMC_KEMPER_PARAM_STOMP_B_DELAY_MODULATION_	LITERAL1
BMC_KEMPER_PARAM_STOMP_B_DELAY_CHORUS	LITERAL1
BMC_KEMPER_PARAM_STOMP_B_FLUTTER_INTENSITY	LITERAL1
BMC_KEMPER_PARAM_STOMP_B_FLUTTER_SHAPE	LITERAL1
BMC_KEMPER_PARAM_STOMP_B_GRIT	LITERAL1
BMC_KEMPER_PARAM_STOMP_B_REVERSE_MIX	LITERAL1
BMC_KEMPER_PARAM_STOMP_B_SWELL	LITERAL1
BMC_KEMPER_PARAM_STOMP_B_SMEAR	LITERAL1
BMC_KEMPER_PARAM_STOMP_B_DUCKING_PRE_POST	LITERAL1
BMC_KEMPER_PARAM_STOMP_C_TYPE	LITERAL1
BMC_KEMPER_PARAM_STOMP_C_ON_OFF_4_MIX	LITERAL1
BMC_KEMPER_PARAM_STOMP_C_VOLUME_7_STEREO	LITERAL1
BMC_KEMPER_PARAM_STOMP_C_WAH_MANUAL	LITERAL1
BMC_KEMPER_PARAM_STOMP_C_WAH_PEAK	LITERAL1
BMC_KEMPER_PARAM_STOMP_C_WAH_RANGE	LITERAL1
BMC_KEMPER_PARAM_STOMP_C_WAH_PEDAL_MODE_	LITERAL1
BMC_KEMPER_PARAM_STOMP_C_WAH_TOUCH_ATTACK_	LITERAL1
BMC_KEMPER_PARAM_STOMP_C_WAH_TOUCH_RELEASE_	LITERAL1
BMC_KEMPER_PARAM_STOMP_C_WAH_TOUCH_BOOST	LITERAL1
BMC_KEMPER_PARAM_STOMP_C_DISTORTION_SHAPER_DRIVE_	LITERAL1
BMC_KEMPER_PARAM_STOMP_C_DISTORTION_BOOSTER_TONE	LITERAL1
BMC_KEMPER_PARAM_STOMP_C_COMPRESSOR_GATE_INTENSITY_	LITERAL1
BMC_KEMPER_PARAM_STOMP_C_COMPRESSOR_ATTACK	LITERAL1
BMC_KEMPER_PARAM_STOMP_C_MODULATION_RATE	LITERAL1
BMC_KEMPER_PARAM_STOMP_C_MODULATION_DEPTH	LITERAL1
BMC_KEMPER_PARAM_STOMP_C_MODULATION_FEEDBACK	LITERAL1
BMC_KEMPER_PARAM_STOMP_C_MODULATION_CROSSOVER	LITERAL1
BMC_KEMPER_PARAM_STOMP_C_MODULATION_HYPERCHORUS_AMOUNT_	LITERAL1
BMC_KEMPER_PARAM_STOMP_C_MODULATION_MANUAL	LITERAL1
BMC_KEMPER_PARAM_STOMP_C_MODULATION_PHASER_PEAK_SPREAD_	LITERAL1
BMC_KEMPER_PARAM_STOMP_C_MODULATION_PHASER_STAGES	LITERAL1
BMC_KEMPER_PARAM_STOMP_C_ROTARY_SPEED__SLOW_FAST__	LITERAL1
BMC_KEMPER_PARAM_STOMP_C_ROTARY_DISTANCE	LITERAL1
BMC_KEMPER_PARAM_STOMP_C_ROTARY_BALANCE	LITERAL1
BMC_KEMPER_PARAM_STOMP_C_COMPRESSOR_SQUASH	LITERAL1
BMC_KEMPER_PARAM_STOMP_C_GRAPHIC_EQ_BAND_1_	LITERAL1
BMC_KEMPER_PARAM_STOMP_C_GRAPHIC_EQ_BAND_2_	LITERAL1
BMC_KEMPER_PARAM_STOMP_C_GRAPHIC_EQ_BAND_3_	LITERAL1
BMC_KEMPER_PARAM_STOMP_C_GRAPHIC_EQ_BAND_4_	LITERAL1
BMC_KEMPER_PARAM_STOMP_C_GRAPHIC_EQ_BAND_5_	LITERAL1
BMC_KEMPER_PARAM_STOMP_C_GRAPHIC_EQ_BAND_6_	LITERAL1
BMC_KEMPER_PARAM_STOMP_C_GRAPHIC_EQ_BAND_7_	LITERAL1
BMC_KEMPER_PARAM_STOMP_C_GRAPHIC_EQ_BAND_8	LITERAL1
BMC_KEMPER_PARAM_STOMP_C_PARAMETRIC_EQ_LOW_GAIN	LITERAL1
BMC_KEMPER_PARAM_STOMP_C_PARAMETRIC_EQ_LOW_FREQUENCY_	LITERAL1
BMC_KEMPER_PARAM_STOMP_C_PARAMETRIC_EQ_HIGH_GAIN	LITERAL1
BMC_KEMPER_PARAM_STOMP_C_PARAMETRIC_EQ_HIGH_FREQUENCY_	LITERAL1
BMC_KEMPER_PARAM_STOMP_C_PARAMETRIC_EQ_PEAK_GAIN	LITERAL1
BMC_KEMPER_PARAM_STOMP_C_PARAMETRIC_EQ_PEAK_FREQUENCY_	LITERAL1
BMC_KEMPER_PARAM_STOMP_C_PARAMETRIC_EQ_PEAK_Q_FACTOR	LITERAL1
BMC_KEMPER_PARAM_STOMP_C_PARAMETRIC_EQ_PEAK_GAIN_2	LITERAL1
BMC_KEMPER_PARAM_STOMP_C_PARAMETRIC_EQ_PEAK_FREQUENCY_2_	LITERAL1
BMC_KEMPER_PARAM_STOMP_C_PARAMETRIC_EQ_PEAK_Q_FACTOR_2	LITERAL1
BMC_KEMPER_PARAM_STOMP_C_WAH_PEAK_RANGE_	LITERAL1
BMC_KEMPER_PARAM_STOMP_C_DUCKING	LITERAL1
BMC_KEMPER_PARAM_STOMP_C_VOICE_MIX_	LITERAL1
BMC_KEMPER_PARAM_STOMP_C_VOICE_1_PITCH_	LITERAL1
BMC_KEMPER_PARAM_STOMP_C_VOICE_2_PITCH_	LITERAL1
BMC_KEMPER_PARAM_STOMP_C_DETUNE	LITERAL1
BMC_KEMPER_PARAM_STOMP_C_SMOOTH_CHORDS_	LITERAL1
BMC_KEMPER_PARAM_STOMP_C_PURE_TUNING	LITERAL1
BMC_KEMPER_PARAM_STOMP_C_KEY	LITERAL1
BMC_KEMPER_PARAM_STOMP_C_FREEZE_FORMANTS_	LITERAL1
BMC_KEMPER_PARAM_STOMP_C_FORMANT_OFFSET_	LITERAL1
BMC_KEMPER_PARAM_STOMP_C_LOW_CUT	LITERAL1
BMC_KEMPER_PARAM_STOMP_C_HIGH_CUT	LITERAL1
BMC_KEMPER_PARAM_STOMP_C_DELAY_MIX	LITERAL1
BMC_KEMPER_PARAM_STOMP_C_DELAY_MIX_PRE_POST_	LITERAL1
BMC_KEMPER_PARAM_STOMP_C_DELAY_TIME_1	LITERAL1
BMC_KEMPER_PARAM_STOMP_C_DELAY_TIME_2	LITERAL1
BMC_KEMPER_PARAM_STOMP_C_DELAY_RATIO_2	LITERAL1
BMC_KEMPER_PARAM_STOMP_C_DELAY_RATIO_3	LITERAL1
BMC_KEMPER_PARAM_STOMP_C_DELAY_RATIO_4	LITERAL1
BMC_KEMPER_PARAM_STOMP_C_DELAY_NOTE_VALUE_1_	LITERAL1
BMC_KEMPER_PARAM_STOMP_C_DELAY_NOTE_VALUE_2_	LITERAL1
BMC_KEMPER_PARAM_STOMP_C_DELAY_NOTE_VALUE_3_	LITERAL1
BMC_KEMPER_PARAM_STOMP_C_DELAY_NOTE_VALUE_4_	LITERAL1
BMC_KEMPER_PARAM_STOMP_C_TO_TEMPO	LITERAL1
BMC_KEMPER_PARAM_STOMP_C_DELAY_VOLUME_1	LITERAL1
BMC_KEMPER_PARAM_STOMP_C_DELAY_VOLUME_2	LITERAL1
BMC_KEMPER_PARAM_STOMP_C_DELAY_VOLUME_3	LITERAL1
BMC_KEMPER_PARAM_STOMP_C_DELAY_VOLUME_4	LITERAL1
BMC_KEMPER_PARAM_STOMP_C_DELAY_PANORAMA_1	LITERAL1
BMC_KEMPER_PARAM_STOMP_C_DELAY_PANORAMA_2	LITERAL1
BMC_KEMPER_PARAM_STOMP_C_DELAY_PANORAMA_3	LITERAL1
BMC_KEMPER_PARAM_STOMP_C_DELAY_PANORAMA_4	LITERAL1
BMC_KEMPER_PARAM_STOMP_C_VOICE3_PITCH	LITERAL1
BMC_KEMPER_PARAM_STOMP_C_VOICE4_PITCH	LITERAL1
BMC_KEMPER_PARAM_STOMP_C_VOICE3_INTERVAL	LITERAL1
BMC_KEMPER_PARAM_STOMP_C_VOICE4_INTERVAL	LITERAL1
BMC_KEMPER_PARAM_STOMP_C_FEEDBACK	LITERAL1
BMC_KEMPER_PARAM_STOMP_C_INFINITY_FEEDBACK	LITERAL1
BMC_KEMPER_PARAM_STOMP_C_INFINITY	LITERAL1
BMC_KEMPER_PARAM_STOMP_C_FEEDBACK2	LITERAL1
BMC_KEMPER_PARAM_STOMP_C_FEEDBACK_SYNC_SWITCH_	LITERAL1
BMC_KEMPER_PARAM_STOMP_C_DELAY_LOW_CUT	LITERAL1
BMC_KEMPER_PARAM_STOMP_C_DELAY_HIGH_CUT	LITERAL1
BMC_KEMPER_PARAM_STOMP_C_DELAY_FILTER_INTENSITY_	LITERAL1
BMC_KEMPER_PARAM_STOMP_C_DELAY_MODULATION_	LITERAL1
BMC_KEMPER_PARAM_STOMP_C_DELAY_CHORUS	LITERAL1
BMC_KEMPER_PARAM_STOMP_C_FLUTTER_INTENSITY	LITERAL1
BMC_KEMPER_PARAM_STOMP_C_FLUTTER_SHAPE	LITERAL1
BMC_KEMPER_PARAM_STOMP_C_GRIT	LITERAL1
BMC_KEMPER_PARAM_STOMP_C_REVERSE_MIX	LITERAL1
BMC_KEMPER_PARAM_STOMP_C_SWELL	LITERAL1
BMC_KEMPER_PARAM_STOMP_C_SMEAR	LITERAL1
BMC_KEMPER_PARAM_STOMP_C_DUCKING_PRE_POST	LITERAL1
BMC_KEMPER_PARAM_STOMP_D_TYPE	LITERAL1
BMC_KEMPER_PARAM_STOMP_D_ON_OFF_4_MIX	LITERAL1
BMC_KEMPER_PARAM_STOMP_D_VOLUME_7_STEREO	LITERAL1
BMC_KEMPER_PARAM_STOMP_D_WAH_MANUAL	LITERAL1
BMC_KEMPER_PARAM_STOMP_D_WAH_PEAK	LITERAL1
BMC_KEMPER_PARAM_STOMP_D_WAH_RANGE	LITERAL1
BMC_KEMPER_PARAM_STOMP_D_WAH_PEDAL_MODE_	LITERAL1
BMC_KEMPER_PARAM_STOMP_D_WAH_TOUCH_ATTACK_	LITERAL1
BMC_KEMPER_PARAM_STOMP_D_WAH_TOUCH_RELEASE_	LITERAL1
BMC_KEMPER_PARAM_STOMP_D_WAH_TOUCH_BOOST	LITERAL1
BMC_KEMPER_PARAM_STOMP_D_DISTORTION_SHAPER_DRIVE_	LITERAL1
BMC_KEMPER_PARAM_STOMP_D_DISTORTION_BOOSTER_TONE	LITERAL1
BMC_KEMPER_PARAM_STOMP_D_COMPRESSOR_GATE_INTENSITY_	LITERAL1
BMC_KEMPER_PARAM_STOMP_D_COMPRESSOR_ATTACK	LITERAL1
BMC_KEMPER_PARAM_STOMP_D_MODULATION_RATE	LITERAL1
BMC_KEMPER_PARAM_STOMP_D_MODULATION_DEPTH	LITERAL1
BMC_KEMPER_PARAM_STOMP_D_MODULATION_FEEDBACK	LITERAL1
BMC_KEMPER_PARAM_STOMP_D_MODULATION_CROSSOVER	LITERAL1
BMC_KEMPER_PARAM_STOMP_D_MODULATION_HYPERCHORUS_AMOUNT_	LITERAL1
BMC_KEMPER_PARAM_STOMP_D_MODULATION_MANUAL	LITERAL1
BMC_KEMPER_PARAM_STOMP_D_MODULATION_PHASER_PEAK_SPREAD_	LITERAL1
BMC_KEMPER_PARAM_STOMP_D_MODULATION_PHASER_STAGES	LITERAL1
BMC_KEMPER_PARAM_STOMP_D_ROTARY_SPEED__SLOW_FAST__	LITERAL1
BMC_KEMPER_PARAM_STOMP_D_ROTARY_DISTANCE	LITERAL1
BMC_KEMPER_PARAM_STOMP_D_ROTARY_BALANCE	LITERAL1
BMC_KEMPER_PARAM_STOMP_D_COMPRESSOR_SQUASH	LITERAL1
BMC_KEMPER_PARAM_STOMP_D_GRAPHIC_EQ_BAND_1_	LITERAL1
BMC_KEMPER_PARAM_STOMP_D_GRAPHIC_EQ_BAND_2_	LITERAL1
BMC_KEMPER_PARAM_STOMP_D_GRAPHIC_EQ_BAND_3_	LITERAL1
BMC_KEMPER_PARAM_STOMP_D_GRAPHIC_EQ_BAND_4_	LITERAL1
BMC_KEMPER_PARAM_STOMP_D_GRAPHIC_EQ_BAND_5_	LITERAL1
BMC_KEMPER_PARAM_STOMP_D_GRAPHIC_EQ_BAND_6_	LITERAL1
BMC_KEMPER_PARAM_STOMP_D_GRAPHIC_EQ_BAND_7_	LITERAL1
BMC_KEMPER_PARAM_STOMP_D_GRAPHIC_EQ_BAND_8	LITERAL1
BMC_KEMPER_PARAM_STOMP_D_PARAMETRIC_EQ_LOW_GAIN	LITERAL1
BMC_KEMPER_PARAM_STOMP_D_PARAMETRIC_EQ_LOW_FREQUENCY_	LITERAL1
BMC_KEMPER_PARAM_STOMP_D_PARAMETRIC_EQ_HIGH_GAIN	LITERAL1
BMC_KEMPER_PARAM_STOMP_D_PARAMETRIC_EQ_HIGH_FREQUENCY_	LITERAL1
BMC_KEMPER_PARAM_STOMP_D_PARAMETRIC_EQ_PEAK_GAIN	LITERAL1
BMC_KEMPER_PARAM_STOMP_D_PARAMETRIC_EQ_PEAK_FREQUENCY_	LITERAL1
BMC_KEMPER_PARAM_STOMP_D_PARAMETRIC_EQ_PEAK_Q_FACTOR	LITERAL1
BMC_KEMPER_PARAM_STOMP_D_PARAMETRIC_EQ_PEAK_GAIN_2	LITERAL1
BMC_KEMPER_PARAM_STOMP_D_PARAMETRIC_EQ_PEAK_FREQUENCY_2_	LITERAL1
BMC_KEMPER_PARAM_STOMP_D_PARAMETRIC_EQ_PEAK_Q_FACTOR_2	LITERAL1
BMC_KEMPER_PARAM_STOMP_D_WAH_PEAK_RANGE_	LITERAL1
BMC_KEMPER_PARAM_STOMP_D_DUCKING	LITERAL1
BMC_KEMPER_PARAM_STOMP_D_VOICE_MIX_	LITERAL1
BMC_KEMPER_PARAM_STOMP_D_VOICE_1_PITCH_	LITERAL1
BMC_KEMPER_PARAM_STOMP_D_VOICE_2_PITCH_	LITERAL1
BMC_KEMPER_PARAM_STOMP_D_DETUNE	LITERAL1
BMC_KEMPER_PARAM_STOMP_D_SMOOTH_CHORDS_	LITERAL1
BMC_KEMPER_PARAM_STOMP_D_PURE_TUNING	LITERAL1
BMC_KEMPER_PARAM_STOMP_D_KEY	LITERAL1
BMC_KEMPER_PARAM_STOMP_D_FREEZE_FORMANTS_	LITERAL1
BMC_KEMPER_PARAM_STOMP_D_FORMANT_OFFSET_	LITERAL1
BMC_KEMPER_PARAM_STOMP_D_LOW_CUT	LITERAL1
BMC_KEMPER_PARAM_STOMP_D_HIGH_CUT	LITERAL1
BMC_KEMPER_PARAM_STOMP_D_DELAY_MIX	LITERAL1
BMC_KEMPER_PARAM_STOMP_D_DELAY_MIX_PRE_POST_	LITERAL1
BMC_KEMPER_PARAM_STOMP_D_DELAY_TIME_1	LITERAL1
BMC_KEMPER_PARAM_STOMP_D_DELAY_TIME_2	LITERAL1
BMC_KEMPER_PARAM_STOMP_D_DELAY_RATIO_2	LITERAL1
BMC_KEMPER_PARAM_STOMP_D_DELAY_RATIO_3	LITERAL1
BMC_KEMPER_PARAM_STOMP_D_DELAY_RATIO_4	LITERAL1
BMC_KEMPER_PARAM_STOMP_D_DELAY_NOTE_VALUE_1_	LITERAL1
BMC_KEMPER_PARAM_STOMP_D_DELAY_NOTE_VALUE_2_	LITERAL1
BMC_KEMPER_PARAM_STOMP_D_DELAY_NOTE_VALUE_3_	LITERAL1
BMC_KEMPER_PARAM_STOMP_D_DELAY_NOTE_VALUE_4_	LITERAL1
BMC_KEMPER_PARAM_STOMP_D_TO_TEMPO	LITERAL1
BMC_KEMPER_PARAM_STOMP_D_DELAY_VOLUME_1	LITERAL1
BMC_KEMPER_PARAM_STOMP_D_DELAY_VOLUME_2	LITERAL1
BMC_KEMPER_PARAM_STOMP_D_DELAY_VOLUME_3	LITERAL1
BMC_KEMPER_PARAM_STOMP_D_DELAY_VOLUME_4	LITERAL1
BMC_KEMPER_PARAM_STOMP_D_DELAY_PANORAMA_1	LITERAL1
BMC_KEMPER_PARAM_STOMP_D_DELAY_PANORAMA_2	LITERAL1
BMC_KEMPER_PARAM_STOMP_D_DELAY_PANORAMA_3	LITERAL1
BMC_KEMPER_PARAM_STOMP_D_DELAY_PANORAMA_4	LITERAL1
BMC_KEMPER_PARAM_STOMP_D_VOICE3_PITCH	LITERAL1
BMC_KEMPER_PARAM_STOMP_D_VOICE4_PITCH	LITERAL1
BMC_KEMPER_PARAM_STOMP_D_VOICE3_INTERVAL	LITERAL1
BMC_KEMPER_PARAM_STOMP_D_VOICE4_INTERVAL	LITERAL1
BMC_KEMPER_PARAM_STOMP_D_FEEDBACK	LITERAL1
BMC_KEMPER_PARAM_STOMP_D_INFINITY_FEEDBACK	LITERAL1
BMC_KEMPER_PARAM_STOMP_D_INFINITY	LITERAL1
BMC_KEMPER_PARAM_STOMP_D_FEEDBACK2	LITERAL1
BMC_KEMPER_PARAM_STOMP_D_FEEDBACK_SYNC_SWITCH_	LITERAL1
BMC_KEMPER_PARAM_STOMP_D_DELAY_LOW_CUT	LITERAL1
BMC_KEMPER_PARAM_STOMP_D_DELAY_HIGH_CUT	LITERAL1
BMC_KEMPER_PARAM_STOMP_D_DELAY_FILTER_INTENSITY_	LITERAL1
BMC_KEMPER_PARAM_STOMP_D_DELAY_MODULATION_	LITERAL1
BMC_KEMPER_PARAM_STOMP_D_DELAY_CHORUS	LITERAL1
BMC_KEMPER_PARAM_STOMP_D_FLUTTER_INTENSITY	LITERAL1
BMC_KEMPER_PARAM_STOMP_D_FLUTTER_SHAPE	LITERAL1
BMC_KEMPER_PARAM_STOMP_D_GRIT	LITERAL1
BMC_KEMPER_PARAM_STOMP_D_REVERSE_MIX	LITERAL1
BMC_KEMPER_PARAM_STOMP_D_SWELL	LITERAL1
BMC_KEMPER_PARAM_STOMP_D_SMEAR	LITERAL1
BMC_KEMPER_PARAM_STOMP_D_DUCKING_PRE_POST	LITERAL1
BMC_KEMPER_PARAM_STOMP_X_TYPE	LITERAL1
BMC_KEMPER_PARAM_STOMP_X_ON_OFF_4_MIX	LITERAL1
BMC_KEMPER_PARAM_STOMP_X_VOLUME_7_STEREO	LITERAL1
BMC_KEMPER_PARAM_STOMP_X_WAH_MANUAL	LITERAL1
BMC_KEMPER_PARAM_STOMP_X_WAH_PEAK	LITERAL1
BMC_KEMPER_PARAM_STOMP_X_WAH_RANGE	LITERAL1
BMC_KEMPER_PARAM_STOMP_X_WAH_PEDAL_MODE_	LITERAL1
BMC_KEMPER_PARAM_STOMP_X_WAH_TOUCH_ATTACK_	LITERAL1
BMC_KEMPER_PARAM_STOMP_X_WAH_TOUCH_RELEASE_	LITERAL1
BMC_KEMPER_PARAM_STOMP_X_WAH_TOUCH_BOOST	LITERAL1
BMC_KEMPER_PARAM_STOMP_X_DISTORTION_SHAPER_DRIVE_	LITERAL1
BMC_KEMPER_PARAM_STOMP_X_DISTORTION_BOOSTER_TONE	LITERAL1
BMC_KEMPER_PARAM_STOMP_X_COMPRESSOR_GATE_INTENSITY_	LITERAL1
BMC_KEMPER_PARAM_STOMP_X_COMPRESSOR_ATTACK	LITERAL1
BMC_KEMPER_PARAM_STOMP_X_MODULATION_RATE	LITERAL1
BMC_KEMPER_PARAM_STOMP_X_MODULATION_DEPTH	LITERAL1
BMC_KEMPER_PARAM_STOMP_X_MODULATION_FEEDBACK	LITERAL1
BMC_KEMPER_PARAM_STOMP_X_MODULATION_CROSSOVER	LITERAL1
BMC_KEMPER_PARAM_STOMP_X_MODULATION_HYPERCHORUS_AMOUNT_	LITERAL1
BMC_KEMPER_PARAM_STOMP_X_MODULATION_MANUAL	LITERAL1
BMC_KEMPER_PARAM_STOMP_X_MODULATION_PHASER_PEAK_SPREAD_	LITERAL1
BMC_KEMPER_PARAM_STOMP_X_MODULATION_PHASER_STAGES	LITERAL1
BMC_KEMPER_PARAM_STOMP_X_ROTARY_SPEED__SLOW_FAST__	LITERAL1
BMC_KEMPER_PARAM_STOMP_X_ROTARY_DISTANCE	LITERAL1
BMC_KEMPER_PARAM_STOMP_X_ROTARY_BALANCE	LITERAL1
BMC_KEMPER_PARAM_STOMP_X_COMPRESSOR_SQUASH	LITERAL1
BMC_KEMPER_PARAM_STOMP_X_GRAPHIC_EQ_BAND_1_	LITERAL1
BMC_KEMPER_PARAM_STOMP_X_GRAPHIC_EQ_BAND_2_	LITERAL1
BMC_KEMPER_PARAM_STOMP_X_GRAPHIC_EQ_BAND_3_	LITERAL1
BMC_KEMPER_PARAM_STOMP_X_GRAPHIC_EQ_BAND_4_	LITERAL1
BMC_KEMPER_PARAM_STOMP_X_GRAPHIC_EQ_BAND_5_	LITERAL1
BMC_KEMPER_PARAM_STOMP_X_GRAPHIC_EQ_BAND_6_	LITERAL1
BMC_KEMPER_PARAM_STOMP_X_GRAPHIC_EQ_BAND_7_	LITERAL1
BMC_KEMPER_PARAM_STOMP_X_GRAPHIC_EQ_BAND_8	LITERAL1
BMC_KEMPER_PARAM_STOMP_X_PARAMETRIC_EQ_LOW_GAIN	LITERAL1
BMC_KEMPER_PARAM_STOMP_X_PARAMETRIC_EQ_LOW_FREQUENCY_	LITERAL1
BMC_KEMPER_PARAM_STOMP_X_PARAMETRIC_EQ_HIGH_GAIN	LITERAL1
BMC_KEMPER_PARAM_STOMP_X_PARAMETRIC_EQ_HIGH_FREQUENCY_	LITERAL1
BMC_KEMPER_PARAM_STOMP_X_PARAMETRIC_EQ_PEAK_GAIN	LITERAL1
BMC_KEMPER_PARAM_STOMP_X_PARAMETRIC_EQ_PEAK_FREQUENCY_	LITERAL1
BMC_KEMPER_PARAM_STOMP_X_PARAMETRIC_EQ_PEAK_Q_FACTOR	LITERAL1
BMC_KEMPER_PARAM_STOMP_X_PARAMETRIC_EQ_PEAK_GAIN_2	LITERAL1
BMC_KEMPER_PARAM_STOMP_X_PARAMETRIC_EQ_PEAK_FREQUENCY_2_	LITERAL1
BMC_KEMPER_PARAM_STOMP_X_PARAMETRIC_EQ_PEAK_Q_FACTOR_2	LITERAL1
BMC_KEMPER_PARAM_STOMP_X_WAH_PEAK_RANGE_	LITERAL1
BMC_KEMPER_PARAM_STOMP_X_DUCKING	LITERAL1
BMC_KEMPER_PARAM_STOMP_X_VOICE_MIX_	LITERAL1
BMC_KEMPER_PARAM_STOMP_X_VOICE_1_PITCH_	LITERAL1
BMC_KEMPER_PARAM_STOMP_X_VOICE_2_PITCH_	LITERAL1
BMC_KEMPER_PARAM_STOMP_X_DETUNE	LITERAL1
BMC_KEMPER_PARAM_STOMP_X_SMOOTH_CHORDS_	LITERAL1
BMC_KEMPER_PARAM_STOMP_X_PURE_TUNING	LITERAL1
BMC_KEMPER_PARAM_STOMP_X_KEY	LITERAL1
BMC_KEMPER_PARAM_STOMP_X_FREEZE_FORMANTS_	LITERAL1
BMC_KEMPER_PARAM_STOMP_X_FORMANT_OFFSET_	LITERAL1
BMC_KEMPER_PARAM_STOMP_X_LOW_CUT	LITERAL1
BMC_KEMPER_PARAM_STOMP_X_HIGH_CUT	LITERAL1
BMC_KEMPER_PARAM_STOMP_X_DELAY_MIX	LITERAL1
BMC_KEMPER_PARAM_STOMP_X_DELAY_MIX_PRE_POST_	LITERAL1
BMC_KEMPER_PARAM_STOMP_X_DELAY_TIME_1	LITERAL1
BMC_KEMPER_PARAM_STOMP_X_DELAY_TIME_2	LITERAL1
BMC_KEMPER_PARAM_STOMP_X_DELAY_RATIO_2	LITERAL1
BMC_KEMPER_PARAM_STOMP_X_DELAY_RATIO_3	LITERAL1
BMC_KEMPER_PARAM_STOMP_X_DELAY_RATIO_4	LITERAL1
BMC_KEMPER_PARAM_STOMP_X_DELAY_NOTE_VALUE_1_	LITERAL1
BMC_KEMPER_PARAM_STOMP_X_DELAY_NOTE_VALUE_2_	LITERAL1
BMC_KEMPER_PARAM_STOMP_X_DELAY_NOTE_VALUE_3_	LITERAL1
BMC_KEMPER_PARAM_STOMP_X_DELAY_NOTE_VALUE_4_	LITERAL1
BMC_KEMPER_PARAM_STOMP_X_TO_TEMPO	LITERAL1
BMC_KEMPER_PARAM_STOMP_X_DELAY_VOLUME_1	LITERAL1
BMC_KEMPER_PARAM_STOMP_X_DELAY_VOLUME_2	LITERAL1
BMC_KEMPER_PARAM_STOMP_X_DELAY_VOLUME_3	LITERAL1
BMC_KEMPER_PARAM_STOMP_X_DELAY_VOLUME_4	LITERAL1
BMC_KEMPER_PARAM_STOMP_X_DELAY_PANORAMA_1	LITERAL1
BMC_KEMPER_PARAM_STOMP_X_DELAY_PANORAMA_2	LITERAL1
BMC_KEMPER_PARAM_STOMP_X_DELAY_PANORAMA_3	LITERAL1
BMC_KEMPER_PARAM_STOMP_X_DELAY_PANORAMA_4	LITERAL1
BMC_KEMPER_PARAM_STOMP_X_VOICE3_PITCH	LITERAL1
BMC_KEMPER_PARAM_STOMP_X_VOICE4_PITCH	LITERAL1
BMC_KEMPER_PARAM_STOMP_X_VOICE3_INTERVAL	LITERAL1
BMC_KEMPER_PARAM_STOMP_X_VOICE4_INTERVAL	LITERAL1
BMC_KEMPER_PARAM_STOMP_X_FEEDBACK	LITERAL1
BMC_KEMPER_PARAM_STOMP_X_INFINITY_FEEDBACK	LITERAL1
BMC_KEMPER_PARAM_STOMP_X_INFINITY	LITERAL1
BMC_KEMPER_PARAM_STOMP_X_FEEDBACK2	LITERAL1
BMC_KEMPER_PARAM_STOMP_X_FEEDBACK_SYNC_SWITCH_	LITERAL1
BMC_KEMPER_PARAM_STOMP_X_DELAY_LOW_CUT	LITERAL1
BMC_KEMPER_PARAM_STOMP_X_DELAY_HIGH_CUT	LITERAL1
BMC_KEMPER_PARAM_STOMP_X_DELAY_FILTER_INTENSITY_	LITERAL1
BMC_KEMPER_PARAM_STOMP_X_DELAY_MODULATION_	LITERAL1
BMC_KEMPER_PARAM_STOMP_X_DELAY_CHORUS	LITERAL1
BMC_KEMPER_PARAM_STOMP_X_FLUTTER_INTENSITY	LITERAL1
BMC_KEMPER_PARAM_STOMP_X_FLUTTER_SHAPE	LITERAL1
BMC_KEMPER_PARAM_STOMP_X_GRIT	LITERAL1
BMC_KEMPER_PARAM_STOMP_X_REVERSE_MIX	LITERAL1
BMC_KEMPER_PARAM_STOMP_X_SWELL	LITERAL1
BMC_KEMPER_PARAM_STOMP_X_SMEAR	LITERAL1
BMC_KEMPER_PARAM_STOMP_X_DUCKING_PRE_POST	LITERAL1
BMC_KEMPER_PARAM_STOMP_MOD_TYPE	LITERAL1
BMC_KEMPER_PARAM_STOMP_MOD_ON_OFF_4_MIX	LITERAL1
BMC_KEMPER_PARAM_STOMP_MOD_VOLUME_7_STEREO	LITERAL1
BMC_KEMPER_PARAM_STOMP_MOD_WAH_MANUAL	LITERAL1
BMC_KEMPER_PARAM_STOMP_MOD_WAH_PEAK	LITERAL1
BMC_KEMPER_PARAM_STOMP_MOD_WAH_RANGE	LITERAL1
BMC_KEMPER_PARAM_STOMP_MOD_WAH_PEDAL_MODE_	LITERAL1
BMC_KEMPER_PARAM_STOMP_MOD_WAH_TOUCH_ATTACK_	LITERAL1
BMC_KEMPER_PARAM_STOMP_MOD_WAH_TOUCH_RELEASE_	LITERAL1
BMC_KEMPER_PARAM_STOMP_MOD_WAH_TOUCH_BOOST	LITERAL1
BMC_KEMPER_PARAM_STOMP_MOD_DISTORTION_SHAPER_DRIVE_	LITERAL1
BMC_KEMPER_PARAM_STOMP_MOD_DISTORTION_BOOSTER_TONE	LITERAL1
BMC_KEMPER_PARAM_STOMP_MOD_COMPRESSOR_GATE_INTENSITY_	LITERAL1
BMC_KEMPER_PARAM_STOMP_MOD_COMPRESSOR_ATTACK	LITERAL1
BMC_KEMPER_PARAM_STOMP_MOD_MODULATION_RATE	LITERAL1
BMC_KEMPER_PARAM_STOMP_MOD_MODULATION_DEPTH	LITERAL1
BMC_KEMPER_PARAM_STOMP_MOD_MODULATION_FEEDBACK	LITERAL1
BMC_KEMPER_PARAM_STOMP_MOD_MODULATION_CROSSOVER	LITERAL1
BMC_KEMPER_PARAM_STOMP_MOD_MODULATION_HYPERCHORUS_AMOUNT_	LITERAL1
BMC_KEMPER_PARAM_STOMP_MOD_MODULATION_MANUAL	LITERAL1
BMC_KEMPER_PARAM_STOMP_MOD_MODULATION_PHASER_PEAK_SPREAD_	LITERAL1
BMC_KEMPER_PARAM_STOMP_MOD_MODULATION_PHASER_STAGES	LITERAL1
BMC_KEMPER_PARAM_STOMP_MOD_ROTARY_SPEED__SLOW_FAST__	LITERAL1
BMC_KEMPER_PARAM_STOMP_MOD_ROTARY_DISTANCE	LITERAL1
BMC_KEMPER_PARAM_STOMP_MOD_ROTARY_BALANCE	LITERAL1
BMC_KEMPER_PARAM_STOMP_MOD_COMPRESSOR_SQUASH	LITERAL1
BMC_KEMPER_PARAM_STOMP_MOD_GRAPHIC_EQ_BAND_1_	LITERAL1
BMC_KEMPER_PARAM_STOMP_MOD_GRAPHIC_EQ_BAND_2_	LITERAL1
BMC_KEMPER_PARAM_STOMP_MOD_GRAPHIC_EQ_BAND_3_	LITERAL1
BMC_KEMPER_PARAM_STOMP_MOD_GRAPHIC_EQ_BAND_4_	LITERAL1
BMC_KEMPER_PARAM_STOMP_MOD_GRAPHIC_EQ_BAND_5_	LITERAL1
BMC_KEMPER_PARAM_STOMP_MOD_GRAPHIC_EQ_BAND_6_	LITERAL1
BMC_KEMPER_PARAM_STOMP_MOD_GRAPHIC_EQ_BAND_7_	LITERAL1
BMC_KEMPER_PARAM_STOMP_MOD_GRAPHIC_EQ_BAND_8	LITERAL1
BMC_KEMPER_PARAM_STOMP_MOD_PARAMETRIC_EQ_LOW_GAIN	LITERAL1
BMC_KEMPER_PARAM_STOMP_MOD_PARAMETRIC_EQ_LOW_FREQUENCY_	LITERAL1
BMC_KEMPER_PARAM_STOMP_MOD_PARAMETRIC_EQ_HIGH_GAIN	LITERAL1
BMC_KEMPER_PARAM_STOMP_MOD_PARAMETRIC_EQ_HIGH_FREQUENCY_	LITERAL1
BMC_KEMPER_PARAM_STOMP_MOD_PARAMETRIC_EQ_PEAK_GAIN	LITERAL1
BMC_KEMPER_PARAM_STOMP_MOD_PARAMETRIC_EQ_PEAK_FREQUENCY_	LITERAL1
BMC_KEMPER_PARAM_STOMP_MOD_PARAMETRIC_EQ_PEAK_Q_FACTOR	LITERAL1
BMC_KEMPER_PARAM_STOMP_MOD_PARAMETRIC_EQ_PEAK_GAIN_2	LITERAL1
BMC_KEMPER_PARAM_STOMP_MOD_PARAMETRIC_EQ_PEAK_FREQUENCY_2_	LITERAL1
BMC_KEMPER_PARAM_STOMP_MOD_PARAMETRIC_EQ_PEAK_Q_FACTOR_2	LITERAL1
BMC_KEMPER_PARAM_STOMP_MOD_WAH_PEAK_RANGE_	LITERAL1
BMC_KEMPER_PARAM_STOMP_MOD_DUCKING	LITERAL1
BMC_KEMPER_PARAM_STOMP_MOD_VOICE_MIX_	LITERAL1
BMC_KEMPER_PARAM_STOMP_MOD_VOICE_1_PITCH_	LITERAL1
BMC_KEMPER_PARAM_STOMP_MOD_VOICE_2_PITCH_	LITERAL1
BMC_KEMPER_PARAM_STOMP_MOD_DETUNE	LITERAL1
BMC_KEMPER_PARAM_STOMP_MOD_SMOOTH_CHORDS_	LITERAL1
BMC_KEMPER_PARAM_STOMP_MOD_PURE_TUNING	LITERAL1
BMC_KEMPER_PARAM_STOMP_MOD_KEY	LITERAL1
BMC_KEMPER_PARAM_STOMP_MOD_FREEZE_FORMANTS_	LITERAL1
BMC_KEMPER_PARAM_STOMP_MOD_FORMANT_OFFSET_	LITERAL1
BMC_KEMPER_PARAM_STOMP_MOD_LOW_CUT	LITERAL1
BMC_KEMPER_PARAM_STOMP_MOD_HIGH_CUT	LITERAL1
BMC_KEMPER_PARAM_STOMP_MOD_DELAY_MIX	LITERAL1
BMC_KEMPER_PARAM_STOMP_MOD_DELAY_MIX_PRE_POST_	LITERAL1
BMC_KEMPER_PARAM_STOMP_MOD_DELAY_TIME_1	LITERAL1
BMC_KEMPER_PARAM_STOMP_MOD_DELAY_TIME_2	LITERAL1
BMC_KEMPER_PARAM_STOMP_MOD_DELAY_RATIO_2	LITERAL1
BMC_KEMPER_PARAM_STOMP_MOD_DELAY_RATIO_3	LITERAL1
BMC_KEMPER_PARAM_STOMP_MOD_DELAY_RATIO_4	LITERAL1
BMC_KEMPER_PARAM_STOMP_MOD_DELAY_NOTE_VALUE_1_	LITERAL1
BMC_KEMPER_PARAM_STOMP_MOD_DELAY_NOTE_VALUE_2_	LITERAL1
BMC_KEMPER_PARAM_STOMP_MOD_DELAY_NOTE_VALUE_3_	LITERAL1
BMC_KEMPER_PARAM_STOMP_MOD_DELAY_NOTE_VALUE_4_	LITERAL1
BMC_KEMPER_PARAM_STOMP_MOD_TO_TEMPO	LITERAL1
BMC_KEMPER_PARAM_STOMP_MOD_DELAY_VOLUME_1	LITERAL1
BMC_KEMPER_PARAM_STOMP_MOD_DELAY_VOLUME_2	LITERAL1
BMC_KEMPER_PARAM_STOMP_MOD_DELAY_VOLUME_3	LITERAL1
BMC_KEMPER_PARAM_STOMP_MOD_DELAY_VOLUME_4	LITERAL1
BMC_KEMPER_PARAM_STOMP_MOD_DELAY_PANORAMA_1	LITERAL1
BMC_KEMPER_PARAM_STOMP_MOD_DELAY_PANORAMA_2	LITERAL1
BMC_KEMPER_PARAM_STOMP_MOD_DELAY_PANORAMA_3	LITERAL1
BMC_KEMPER_PARAM_STOMP_MOD_DELAY_PANORAMA_4	LITERAL1
BMC_KEMPER_PARAM_STOMP_MOD_VOICE3_PITCH	LITERAL1
BMC_KEMPER_PARAM_STOMP_MOD_VOICE4_PITCH	LITERAL1
BMC_KEMPER_PARAM_STOMP_MOD_VOICE3_INTERVAL	LITERAL1
BMC_KEMPER_PARAM_STOMP_MOD_VOICE4_INTERVAL	LITERAL1
BMC_KEMPER_PARAM_STOMP_MOD_FEEDBACK	LITERAL1
BMC_KEMPER_PARAM_STOMP_MOD_INFINITY_FEEDBACK	LITERAL1
BMC_KEMPER_PARAM_STOMP_MOD_INFINITY	LITERAL1
BMC_KEMPER_PARAM_STOMP_MOD_FEEDBACK2	LITERAL1
BMC_KEMPER_PARAM_STOMP_MOD_FEEDBACK_SYNC_SWITCH_	LITERAL1
BMC_KEMPER_PARAM_STOMP_MOD_DELAY_LOW_CUT	LITERAL1
BMC_KEMPER_PARAM_STOMP_MOD_DELAY_HIGH_CUT	LITERAL1
BMC_KEMPER_PARAM_STOMP_MOD_DELAY_FILTER_INTENSITY_	LITERAL1
BMC_KEMPER_PARAM_STOMP_MOD_DELAY_MODULATION_	LITERAL1
BMC_KEMPER_PARAM_STOMP_MOD_DELAY_CHORUS	LITERAL1
BMC_KEMPER_PARAM_STOMP_MOD_FLUTTER_INTENSITY	LITERAL1
BMC_KEMPER_PARAM_STOMP_MOD_FLUTTER_SHAPE	LITERAL1
BMC_KEMPER_PARAM_STOMP_MOD_GRIT	LITERAL1
BMC_KEMPER_PARAM_STOMP_MOD_REVERSE_MIX	LITERAL1
BMC_KEMPER_PARAM_STOMP_MOD_SWELL	LITERAL1
BMC_KEMPER_PARAM_STOMP_MOD_SMEAR	LITERAL1
BMC_KEMPER_PARAM_STOMP_MOD_DUCKING_PRE_POST	LITERAL1
BMC_KEMPER_PARAM_STOMP_DELAY_TYPE	LITERAL1
BMC_KEMPER_PARAM_STOMP_DELAY_ON_OFF_4_MIX	LITERAL1
BMC_KEMPER_PARAM_STOMP_DELAY_VOLUME_7_STEREO	LITERAL1
BMC_KEMPER_PARAM_STOMP_DELAY_WAH_MANUAL	LITERAL1
BMC_KEMPER_PARAM_STOMP_DELAY_WAH_PEAK	LITERAL1
BMC_KEMPER_PARAM_STOMP_DELAY_WAH_RANGE	LITERAL1
BMC_KEMPER_PARAM_STOMP_DELAY_WAH_PEDAL_MODE_	LITERAL1
BMC_KEMPER_PARAM_STOMP_DELAY_WAH_TOUCH_ATTACK_	LITERAL1
BMC_KEMPER_PARAM_STOMP_DELAY_WAH_TOUCH_RELEASE_	LITERAL1
BMC_KEMPER_PARAM_STOMP_DELAY_WAH_TOUCH_BOOST	LITERAL1
BMC_KEMPER_PARAM_STOMP_DELAY_DISTORTION_SHAPER_DRIVE_	LITERAL1
BMC_KEMPER_PARAM_STOMP_DELAY_DISTORTION_BOOSTER_TONE	LITERAL1
BMC_KEMPER_PARAM_STOMP_DELAY_COMPRESSOR_GATE_INTENSITY_	LITERAL1
BMC_KEMPER_PARAM_STOMP_DELAY_COMPRESSOR_ATTACK	LITERAL1
BMC_KEMPER_PARAM_STOMP_DELAY_MODULATION_RATE	LITERAL1
BMC_KEMPER_PARAM_STOMP_DELAY_MODULATION_DEPTH	LITERAL1
BMC_KEMPER_PARAM_STOMP_DELAY_MODULATION_FEEDBACK	LITERAL1
BMC_KEMPER_PARAM_STOMP_DELAY_MODULATION_CROSSOVER	LITERAL1
BMC_KEMPER_PARAM_STOMP_DELAY_MODULATION_HYPERCHORUS_AMOUNT_	LITERAL1
BMC_KEMPER_PARAM_STOMP_DELAY_MODULATION_MANUAL	LITERAL1
BMC_KEMPER_PARAM_STOMP_DELAY_MODULATION_PHASER_PEAK_SPREAD_	LITERAL1
BMC_KEMPER_PARAM_STOMP_DELAY_MODULATION_PHASER_STAGES	LITERAL1
BMC_KEMPER_PARAM_STOMP_DELAY_ROTARY_SPEED__SLOW_FAST__	LITERAL1
BMC_KEMPER_PARAM_STOMP_DELAY_ROTARY_DISTANCE	LITERAL1
BMC_KEMPER_PARAM_STOMP_DELAY_ROTARY_BALANCE	LITERAL1
BMC_KEMPER_PARAM_STOMP_DELAY_COMPRESSOR_SQUASH	LITERAL1
BMC_KEMPER_PARAM_STOMP_DELAY_GRAPHIC_EQ_BAND_1_	LITERAL1
BMC_KEMPER_PARAM_STOMP_DELAY_GRAPHIC_EQ_BAND_2_	LITERAL1
BMC_KEMPER_PARAM_STOMP_DELAY_GRAPHIC_EQ_BAND_3_	LITERAL1
BMC_KEMPER_PARAM_STOMP_DELAY_GRAPHIC_EQ_BAND_4_	LITERAL1
BMC_KEMPER_PARAM_STOMP_DELAY_GRAPHIC_EQ_BAND_5_	LITERAL1
BMC_KEMPER_PARAM_STOMP_DELAY_GRAPHIC_EQ_BAND_6_	LITERAL1
BMC_KEMPER_PARAM_STOMP_DELAY_GRAPHIC_EQ_BAND_7_	LITERAL1
BMC_KEMPER_PARAM_STOMP_DELAY_GRAPHIC_EQ_BAND_8	LITERAL1
BMC_KEMPER_PARAM_STOMP_DELAY_PARAMETRIC_EQ_LOW_GAIN	LITERAL1
BMC_KEMPER_PARAM_STOMP_DELAY_PARAMETRIC_EQ_LOW_FREQUENCY_	LITERAL1
BMC_KEMPER_PARAM_STOMP_DELAY_PARAMETRIC_EQ_HIGH_GAIN	LITERAL1
BMC_KEMPER_PARAM_STOMP_DELAY_PARAMETRIC_EQ_HIGH_FREQUENCY_	LITERAL1
BMC_KEMPER_PARAM_STOMP_DELAY_PARAMETRIC_EQ_PEAK_GAIN	LITERAL1
BMC_KEMPER_PARAM_STOMP_DELAY_PARAMETRIC_EQ_PEAK_FREQUENCY_	LITERAL1
BMC_KEMPER_PARAM_STOMP_DELAY_PARAMETRIC_EQ_PEAK_Q_FACTOR	LITERAL1
BMC_KEMPER_PARAM_STOMP_DELAY_PARAMETRIC_EQ_PEAK_GAIN_2	LITERAL1
BMC_KEMPER_PARAM_STOMP_DELAY_PARAMETRIC_EQ_PEAK_FREQUENCY_2_	LITERAL1
BMC_KEMPER_PARAM_STOMP_DELAY_PARAMETRIC_EQ_PEAK_Q_FACTOR_2	LITERAL1
BMC_KEMPER_PARAM_STOMP_DELAY_WAH_PEAK_RANGE_	LITERAL1
BMC_KEMPER_PARAM_STOMP_DELAY_DUCKING	LITERAL1
BMC_KEMPER_PARAM_STOMP_DELAY_VOICE_MIX_	LITERAL1
BMC_KEMPER_PARAM_STOMP_DELAY_VOICE_1_PITCH_	LITERAL1
BMC_KEMPER_PARAM_STOMP_DELAY_VOICE_2_PITCH_	LITERAL1
BMC_KEMPER_PARAM_STOMP_DELAY_DETUNE	LITERAL1
BMC_KEMPER_PARAM_STOMP_DELAY_SMOOTH_CHORDS_	LITERAL1
BMC_KEMPER_PARAM_STOMP_DELAY_PURE_TUNING	LITERAL1
BMC_KEMPER_PARAM_STOMP_DELAY_KEY	LITERAL1
BMC_KEMPER_PARAM_STOMP_DELAY_FREEZE_FORMANTS_	LITERAL1
BMC_KEMPER_PARAM_STOMP_DELAY_FORMANT_OFFSET_	LITERAL1
BMC_KEMPER_PARAM_STOMP_DELAY_LOW_CUT	LITERAL1
BMC_KEMPER_PARAM_STOMP_DELAY_HIGH_CUT	LITERAL1
BMC_KEMPER_PARAM_STOMP_DELAY_DELAY_MIX	LITERAL1
BMC_KEMPER_PARAM_STOMP_DELAY_DELAY_MIX_PRE_POST_	LITERAL1
BMC_KEMPER_PARAM_STOMP_DELAY_DELAY_TIME_1	LITERAL1
BMC_KEMPER_PARAM_STOMP_DELAY_DELAY_TIME_2	LITERAL1
BMC_KEMPER_PARAM_STOMP_DELAY_DELAY_RATIO_2	LITERAL1
BMC_KEMPER_PARAM_STOMP_DELAY_DELAY_RATIO_3	LITERAL1
BMC_KEMPER_PARAM_STOMP_DELAY_DELAY_RATIO_4	LITERAL1
BMC_KEMPER_PARAM_STOMP_DELAY_DELAY_NOTE_VALUE_1_	LITERAL1
BMC_KEMPER_PARAM_STOMP_DELAY_DELAY_NOTE_VALUE_2_	LITERAL1
BMC_KEMPER_PARAM_STOMP_DELAY_DELAY_NOTE_VALUE_3_	LITERAL1
BMC_KEMPER_PARAM_STOMP_DELAY_DELAY_NOTE_VALUE_4_	LITERAL1
BMC_KEMPER_PARAM_STOMP_DELAY_TO_TEMPO	LITERAL1
BMC_KEMPER_PARAM_STOMP_DELAY_DELAY_VOLUME_1	LITERAL1
BMC_KEMPER_PARAM_STOMP_DELAY_DELAY_VOLUME_2	LITERAL1
BMC_KEMPER_PARAM_STOMP_DELAY_DELAY_VOLUME_3	LITERAL1
BMC_KEMPER_PARAM_STOMP_DELAY_DELAY_VOLUME_4	LITERAL1
BMC_KEMPER_PARAM_STOMP_DELAY_DELAY_PANORAMA_1	LITERAL1
BMC_KEMPER_PARAM_STOMP_DELAY_DELAY_PANORAMA_2	LITERAL1
BMC_KEMPER_PARAM_STOMP_DELAY_DELAY_PANORAMA_3	LITERAL1
BMC_KEMPER_PARAM_STOMP_DELAY_DELAY_PANORAMA_4	LITERAL1
BMC_KEMPER_PARAM_STOMP_DELAY_VOICE3_PITCH	LITERAL1
BMC_KEMPER_PARAM_STOMP_DELAY_VOICE4_PITCH	LITERAL1
BMC_KEMPER_PARAM_STOMP_DELAY_VOICE3_INTERVAL	LITERAL1
BMC_KEMPER_PARAM_STOMP_DELAY_VOICE4_INTERVAL	LITERAL1
BMC_KEMPER_PARAM_STOMP_DELAY_FEEDBACK	LITERAL1
BMC_KEMPER_PARAM_STOMP_DELAY_INFINITY_FEEDBACK	LITERAL1
BMC_KEMPER_PARAM_STOMP_DELAY_INFINITY	LITERAL1
BMC_KEMPER_PARAM_STOMP_DELAY_FEEDBACK2	LITERAL1
BMC_KEMPER_PARAM_STOMP_DELAY_FEEDBACK_SYNC_SWITCH_	LITERAL1
BMC_KEMPER_PARAM_STOMP_DELAY_DELAY_LOW_CUT	LITERAL1
BMC_KEMPER_PARAM_STOMP_DELAY_DELAY_HIGH_CUT	LITERAL1
BMC_KEMPER_PARAM_STOMP_DELAY_DELAY_FILTER_INTENSITY_	LITERAL1
BMC_KEMPER_PARAM_STOMP_DELAY_DELAY_MODULATION_	LITERAL1
BMC_KEMPER_PARAM_STOMP_DELAY_DELAY_CHORUS	LITERAL1
BMC_KEMPER_PARAM_STOMP_DELAY_FLUTTER_INTENSITY	LITERAL1
BMC_KEMPER_PARAM_STOMP_DELAY_FLUTTER_SHAPE	LITERAL1
BMC_KEMPER_PARAM_STOMP_DELAY_GRIT	LITERAL1
BMC_KEMPER_PARAM_STOMP_DELAY_REVERSE_MIX	LITERAL1
BMC_KEMPER_PARAM_STOMP_DELAY_SWELL	LITERAL1
BMC_KEMPER_PARAM_STOMP_DELAY_SMEAR	LITERAL1
BMC_KEMPER_PARAM_STOMP_DELAY_DUCKING_PRE_POST	LITERAL1
BMC_KEMPER_PARAM_REVERB_TYPE	LITERAL1
BMC_KEMPER_PARAM_REVERB_ON_OFF__CUTS_TAIL_	LITERAL1
BMC_KEMPER_PARAM_REVERB_MIX	LITERAL1
BMC_KEMPER_PARAM_REVERB_VOLUME	LITERAL1
BMC_KEMPER_PARAM_REVERB_DEL_REV_BALANCE	LITERAL1
BMC_KEMPER_PARAM_REVERB_TIME	LITERAL1
BMC_KEMPER_PARAM_REVERB_DAMPING	LITERAL1
BMC_KEMPER_PARAM_REVERB_BANDWIDTH	LITERAL1
BMC_KEMPER_PARAM_REVERB_CENTER_FREQUENCY_	LITERAL1
BMC_KEMPER_PARAM_REVERB_PRE_DELAY	LITERAL1
BMC_KEMPER_PARAM_REVERB_ON_OFF__KEEPS_TAIL__	LITERAL1
BMC_KEMPER_PARAM_REVERB_DUCKING	LITERAL1
BMC_KEMPER_PARAM_SYSTEM_GLOBAL_STOMP_A_HOLD_108_STOMP_B_HOLD_	LITERAL1
BMC_KEMPER_PARAM_SYSTEM_GLOBAL_STOMP_C_HOLD_110_STOMP_D_HOLD_	LITERAL1
BMC_KEMPER_PARAM_SYSTEM_GLOBAL_STOMP_X_HOLD_113_STOMP_MOD_HOLD_	LITERAL1
BMC_KEMPER_PARAM_SYSTEM_GLOBAL_STOMP_DLY_HOLD	LITERAL1
BMC_KEMPER_PARAM_SYSTEM_GLOBAL_MAIN_OUTPUT_VOLUME	LITERAL1
BMC_KEMPER_PARAM_SYSTEM_GLOBAL_HEADPHONE_OUTPUT_VOLUME_	LITERAL1
BMC_KEMPER_PARAM_SYSTEM_GLOBAL_MONITOR_OUTPUT_VOLUME	LITERAL1
BMC_KEMPER_PARAM_SYSTEM_GLOBAL_DIRECT_OUTPUT_VOLUME	LITERAL1
BMC_KEMPER_PARAM_SYSTEM_GLOBAL_SPDIF_INPUT_ENABLE	LITERAL1
BMC_KEMPER_PARAM_SYSTEM_GLOBAL_MAIN_OUTPUT_EQ_BASS	LITERAL1
BMC_KEMPER_PARAM_SYSTEM_GLOBAL_MAIN_OUTPUT_EQ_MIDDLE	LITERAL1
BMC_KEMPER_PARAM_SYSTEM_GLOBAL_MAIN_OUTPUT_EQ_TREBLE	LITERAL1
BMC_KEMPER_PARAM_SYSTEM_GLOBAL_MAIN_OUTPUT_EQ_PRESENCE	LITERAL1
BMC_KEMPER_PARAM_SYSTEM_GLOBAL_MONITOR_OUTPUT_EQ_BASS	LITERAL1
BMC_KEMPER_PARAM_SYSTEM_GLOBAL_MONITOR_OUTPUT_EQ_MIDDLE	LITERAL1
BMC_KEMPER_PARAM_SYSTEM_GLOBAL_MONITOR_OUTPUT_EQ_TREBLE	LITERAL1
BMC_KEMPER_PARAM_SYSTEM_GLOBAL_MONITOR_OUTPUT_EQ_PRESENCE	LITERAL1
BMC_KEMPER_PARAM_SYSTEM_GLOBAL_LOOPER_VOLUME_	LITERAL1
BMC_KEMPER_PARAM_SYSTEM_GLOBAL_LOOPER_LOCATION	LITERAL1
BMC_EDITOR_POT_STYLE_KNOB	LITERAL1
BMC_EDITOR_POT_STYLE_FADER	LITERAL1
BMC_EDITOR_POT_STYLE_EXPRESSION	LITERAL1
BMC_RELAY_EVENT_TYPE_PRESET	LITERAL1
BMC_RELAY_EVENT_TYPE_PAGE	LITERAL1

BMC_PWM_LED_EVENT_TYPE_MIDI_IN	LITERAL1
BMC_PWM_LED_EVENT_TYPE_MIDI_OUT	LITERAL1
BMC_PWM_LED_EVENT_TYPE_EDITOR_CONNECTED	LITERAL1
BMC_PWM_LED_EVENT_TYPE_HOST_CONNECTED	LITERAL1
BMC_PWM_LED_EVENT_TYPE_BLE_CONNECTED	LITERAL1
BMC_PWM_LED_EVENT_TYPE_CLOCK_SYNC	LITERAL1
BMC_PWM_LED_EVENT_TYPE_PRESET	LITERAL1
BMC_PWM_LED_EVENT_TYPE_PAGE	LITERAL1
BMC_PWM_LED_EVENT_TYPE_BUTTON	LITERAL1
BMC_PWM_LED_EVENT_TYPE_POT	LITERAL1

BMC_POT_EVENT_TYPE_CLOCK	LITERAL1
BMC_POT_EVENT_TYPE_BEATBUDDY_CMD	LITERAL1
BMC_POT_EVENT_TYPE_CLICK_TRACK_FREQ	LITERAL1
BMC_POT_EVENT_TYPE_CLICK_TRACK_LEVEL	LITERAL1
BMC_ENCODER_EVENT_TYPE_CLOCK	LITERAL1
BMC_ENCODER_EVENT_TYPE_PAGES	LITERAL1
BMC_ENCODER_EVENT_TYPE_PRESETS	LITERAL1
BMC_ENCODER_EVENT_TYPE_TMP_SCROLLER_PAGES	LITERAL1
BMC_ENCODER_EVENT_TYPE_TMP_SCROLLER_PRESETS	LITERAL1
BMC_ENCODER_EVENT_TYPE_BEATBUDDY_CMD	LITERAL1
BMC_ENCODER_EVENT_TYPE_LIBRARY	LITERAL1
BMC_ENCODER_EVENT_TYPE_CUSTOM_SYSEX	LITERAL1
BMC_ENCODER_EVENT_TYPE_PROGRAM_BANKING_SCROLL	LITERAL1
BMC_ENCODER_EVENT_TYPE_CLICK_TRACK_FREQ	LITERAL1
BMC_ENCODER_EVENT_TYPE_CLICK_TRACK_LEVEL	LITERAL1
BMC_ENCODER_EVENT_TYPE_FAS_PRESET	LITERAL1
BMC_ENCODER_EVENT_TYPE_FAS_SCENE	LITERAL1
BMC_ENCODER_EVENT_TYPE_FAS_PARAM	LITERAL1
BMC_ENCODER_EVENT_TYPE_MENU	LITERAL1
BMC_TRIGGER_EVENT_TYPE_RELAY_MESSAGE	LITERAL1
BMC_TRIGGER_EVENT_TYPE_CLOCK_TAP	LITERAL1
BMC_TRIGGER_EVENT_TYPE_BUTTON	LITERAL1
BMC_TRIGGER_EVENT_TYPE_LIBRARY	LITERAL1
BMC_TRIGGER_EVENT_TYPE_LIBRARY2	LITERAL1
BMC_TRIGGER_EVENT_TYPE_LIBRARY3	LITERAL1
BMC_TRIGGER_EVENT_TYPE_PRESET	LITERAL1
BMC_TRIGGER_EVENT_TYPE_PRESET_SCROLL	LITERAL1
BMC_TRIGGER_EVENT_TYPE_PAGE	LITERAL1
BMC_TRIGGER_EVENT_TYPE_PAGE_SCROLL	LITERAL1
BMC_TRIGGER_EVENT_TYPE_PAGE_ACTIVE_SENSE	LITERAL1
BMC_TRIGGER_EVENT_TYPE_RELAY_NL_CONTROL	LITERAL1
BMC_TRIGGER_EVENT_TYPE_RELAY_L_CONTROL	LITERAL1
BMC_TRIGGER_EVENT_TYPE_SETLIST	LITERAL1
BMC_TRIGGER_EVENT_TYPE_SETLIST_SCROLL	LITERAL1
BMC_TRIGGER_EVENT_TYPE_SETLIST_SONG	LITERAL1
BMC_TRIGGER_EVENT_TYPE_SETLIST_SONG_SCROLL	LITERAL1
BMC_TRIGGER_EVENT_TYPE_GLOBAL_BUTTON	LITERAL1
BMC_TRIGGER_EVENT_TYPE_ENCODER	LITERAL1
BMC_TRIGGER_EVENT_TYPE_GLOBAL_ENCODER	LITERAL1
BMC_TRIGGER_EVENT_TYPE_CUSTOM	LITERAL1
BMC_EDITOR_SYSEX_FLAG_WRITE	LITERAL1
BMC_EDITOR_SYSEX_FLAG_PAGE	LITERAL1
BMC_EDITOR_SYSEX_FLAG_ALL_PAGES	LITERAL1
BMC_EDITOR_SYSEX_FLAG_BACKUP	LITERAL1
BMC_EDITOR_SYSEX_FLAG_ERROR	LITERAL1
BMC_CTRL_GROUP_HARDWARE	LITERAL1
BMC_CTRL_GROUP_PRESET	LITERAL1
BMC_CTRL_GROUP_CLICK_TRACK	LITERAL1
BMC_CTRL_PAGE_GET	LITERAL1
BMC_CTRL_PAGE_SET	LITERAL1
BMC_CTRL_BUTTON_TRIGGER_TOGGLE	LITERAL1
BMC_CTRL_BUTTON_TRIGGER_PRESS	LITERAL1
BMC_CTRL_BUTTON_TRIGGER_RELEASE	LITERAL1
BMC_CTRL_LED_STATES	LITERAL1
BMC_CTRL_LED_TEST	LITERAL1
BMC_CTRL_PWM_LED_STATES	LITERAL1
BMC_CTRL_PWM_LED_TEST	LITERAL1
BMC_CTRL_PIXEL_STATES	LITERAL1
BMC_CTRL_PIXEL_TEST	LITERAL1
BMC_CTRL_GLOBAL_LED_STATES	LITERAL1
BMC_CTRL_GLOBAL_LED_TEST	LITERAL1
BMC_CTRL_POT_STATES	LITERAL1
BMC_CTRL_POT_CALIBRATION	LITERAL1
BMC_CTRL_POT_CALIBRATION_CANCEL	LITERAL1
BMC_CTRL_NL_RELAYS_GET	LITERAL1
BMC_CTRL_NL_RELAYS_OPEN	LITERAL1
BMC_CTRL_NL_RELAYS_CLOSE	LITERAL1
BMC_CTRL_NL_RELAYS_TOGGLE	LITERAL1
BMC_CTRL_L_RELAYS_GET	LITERAL1
BMC_CTRL_L_RELAYS_SET	LITERAL1
BMC_CTRL_L_RELAYS_RESET	LITERAL1
BMC_CTRL_L_RELAYS_TOGGLE	LITERAL1
BMC_CTRL_GLOBAL_POT_STATES	LITERAL1
BMC_CTRL_GLOBAL_POT_CALIBRATION	LITERAL1
BMC_CTRL_GLOBAL_POT_CALIBRATION_CANCEL	LITERAL1
BMC_CTRL_AUX_JACK_STATES	LITERAL1
BMC_CTRL_RGB_PIXEL_STATES	LITERAL1
BMC_CTRL_RGB_PIXEL_TEST	LITERAL1
BMC_CTRL_PRESET_GET	LITERAL1
BMC_CTRL_PRESET_SET	LITERAL1
BMC_CTRL_CLICK_TRACK_ALL	LITERAL1
BMC_CTRL_CLICK_TRACK_FREQUENCY	LITERAL1
BMC_CTRL_CLICK_TRACK_LEVEL	LITERAL1
BMC_CTRL_CLICK_TRACK_MUTE	LITERAL1
